/people/appointed_role/appointment./people/appointment/appointed_by	/people/appointed_role	/people/appointer
/location/statistical_region/rent50_2./measurement_unit/dated_money_value/currency	/location/statistical_region	/finance/currency
/tv/tv_series_episode/guest_stars./tv/tv_guest_role/actor	/tv/tv_series_episode	/tv/tv_actor
/music/performance_role/track_performances./music/track_contribution/contributor	/music/performance_role	/music/artist
/medicine/disease/prevention_factors	/medicine/disease	/medicine/condition_prevention_factors
/organization/organization_member/member_of./organization/organization_membership/organization	/organization/organization_member	/organization/membership_organization
/american_football/football_player/receiving./american_football/player_receiving_statistics/season	/american_football/football_player	/sports/sports_league_season
/user/narphorium/people/wealthy_person/net_worth./measurement_unit/dated_money_value/currency	/user/narphorium/people/wealthy_person	/finance/currency
/business/company_type/companies_of_this_type	/business/company_type	/organization/organization
/tv/tv_program/regular_cast./tv/regular_tv_appearance/character	/tv/tv_program	/tv/tv_character
/base/popstra/religion/membership./base/popstra/religion_choice/member	/base/popstra/religion	/base/popstra/celebrity
/base/x2010fifaworldcupsouthafrica/world_cup_squad/current_world_cup_squad./base/x2010fifaworldcupsouthafrica/current_world_cup_squad/position	/base/x2010fifaworldcupsouthafrica/world_cup_squad	/soccer/football_position
/government/politician/government_positions_held./government/government_position_held/jurisdiction_of_office	/government/politician	/government/governmental_jurisdiction
/computer/programming_language/influenced_by	/computer/programming_language	/computer/programming_language
/base/folklore/mythology/mythical_creatures	/base/folklore/mythology	/base/folklore/mythical_creature
/fictional_universe/fictional_character/species	/fictional_universe/fictional_character	/fictional_universe/character_species
/cvg/game_character/games./cvg/game_performance/game	/cvg/game_character	/cvg/computer_videogame
/education/field_of_study/students_majoring./education/education/minor	/education/field_of_study	/education/field_of_study
/people/cause_of_death/includes_causes_of_death	/people/cause_of_death	/people/cause_of_death
/base/onephylogeny/type_of_thing/includes	/base/onephylogeny/type_of_thing	/base/onephylogeny/type_of_thing
/film/film/runtime./film/film_cut/type_of_film_cut	/film/film	/film/film_cut_type
/astronomy/star_system/planetary_system	/astronomy/star_system	/astronomy/star_system_body
/film/actor/dubbing_performances./film/dubbing_performance/language	/film/actor	/language/human_language
/base/popstra/organization/supporter./base/popstra/support/supporter	/base/popstra/organization	/base/popstra/celebrity
/media_common/dedicatee/dedications./media_common/dedication/dedicated_by	/media_common/dedicatee	/media_common/dedicator
/education/field_of_study/students_majoring./education/education/major_field_of_study	/education/field_of_study	/education/field_of_study
/biology/animal_breed/place_of_origin	/biology/animal_breed	/biology/breed_origin
/film/film/starring./film/performance/special_performance_type	/film/film	/film/special_film_performance_type
/media_common/media_genre/child_genres	/media_common/media_genre	/media_common/media_genre
/base/popstra/celebrity/shops_at./base/popstra/shopping_choice/company	/base/popstra/celebrity	/base/popstra/company
/finance/currency/countries_used	/finance/currency	/location/country
/visual_art/visual_art_genre/artworks	/visual_art/visual_art_genre	/visual_art/artwork
/location/capital_of_administrative_division/capital_of./location/administrative_division_capital_relationship/administrative_division	/location/capital_of_administrative_division	/location/administrative_division
/base/x2010fifaworldcupsouthafrica/world_cup_participant/world_cup_team./base/x2010fifaworldcupsouthafrica/current_world_cup_squad/position	/base/x2010fifaworldcupsouthafrica/world_cup_participant	/soccer/football_position
/food/diet/followers	/food/diet	/food/diet_follower
/tv/special_tv_performance_type/starring_performances./tv/regular_tv_appearance/character	/tv/special_tv_performance_type	/tv/tv_character
/people/marriage_union_type/unions_of_this_type./people/marriage/spouse	/people/marriage_union_type	/people/person
/organization/organization_sector/organizations_in_this_sector	/organization/organization_sector	/organization/organization
/baseball/baseball_team/team_stats./baseball/baseball_team_stats/season	/baseball/baseball_team	/sports/sports_league_season
/award/award_category/disciplines_or_subjects	/award/award_category	/award/award_discipline
/base/yalebase/secret_society_member/belonged_to./base/yalebase/secret_society_membership/society	/base/yalebase/secret_society_member	/base/yalebase/secret_society
/government/governmental_body/body_this_is_a_component_of	/government/governmental_body	/government/governmental_body
/people/person/parents	/people/person	/people/person
/user/jg/default_domain/olympic_games/sports	/user/jg/default_domain/olympic_games	/user/jg/default_domain/olympic_sport
/medicine/disease/includes_diseases	/medicine/disease	/medicine/disease
/biology/animal_breed/breed_of	/biology/animal_breed	/biology/domesticated_animal
/olympics/olympic_participating_country/athletes./olympics/olympic_athlete_affiliation/sport	/olympics/olympic_participating_country	/olympics/olympic_sport
/people/person/nationality	/people/person	/location/country
/base/biblioness/bibs_location/state	/base/biblioness/bibs_location	/location/location
/location/statistical_region/rent50_3./measurement_unit/dated_money_value/currency	/location/statistical_region	/finance/currency
/cvg/computer_videogame/prequel	/cvg/computer_videogame	/cvg/computer_videogame
/music/genre/parent_genre	/music/genre	/music/genre
/location/country/languages_spoken	/location/country	/language/human_language
/film/special_film_performance_type/film_performance_type./film/performance/actor	/film/special_film_performance_type	/film/actor
/base/thoroughbredracing/thoroughbred_racehorse_sex/horses_of_this_sex	/base/thoroughbredracing/thoroughbred_racehorse_sex	/base/thoroughbredracing/thoroughbred_racehorse
/tv/tv_genre/programs	/tv/tv_genre	/tv/tv_program
/base/thoroughbredracing/thoroughbred_racehorse_color/horses_of_this_color	/base/thoroughbredracing/thoroughbred_racehorse_color	/base/thoroughbredracing/thoroughbred_racehorse
/music/group_member/membership./music/group_membership/group	/music/group_member	/music/musical_group
/film/film_genre/films_in_this_genre	/film/film_genre	/film/film
/american_football/football_player/games./american_football/player_game_statistics/season	/american_football/football_player	/sports/sports_league_season
/fictional_universe/fictional_universe/characters	/fictional_universe/fictional_universe	/fictional_universe/fictional_character
/interests/collection_category/parent_category	/interests/collection_category	/interests/collection_category
/business/consumer_product/company./business/company_product_relationship/company	/business/consumer_product	/business/consumer_company
/film/film/film_art_direction_by	/film/film	/film/film_art_director
/base/locations/countries/continent	/base/locations/countries	/base/locations/continents
/music/artist/label	/music/artist	/music/record_label
/theater/theater_actor/theater_roles./theater/theater_role/role	/theater/theater_actor	/theater/theater_character
/people/cause_of_death/people	/people/cause_of_death	/people/deceased_person
/tv/tv_network/areas_served	/tv/tv_network	/location/location
/base/aareas/schema/administrative_area/administrative_parent	/base/aareas/schema/administrative_area	/base/aareas/schema/administrative_area
/book/book_subject/works	/book/book_subject	/book/written_work
/base/infrastructure/power_station/fuel_type	/base/infrastructure/power_station	/base/infrastructure/power_plant_type
/projects/project_participant/projects./projects/project_participation/role	/projects/project_participant	/projects/project_role
/medicine/drug_class/drugs	/medicine/drug_class	/medicine/drug
/soccer/football_position/players	/soccer/football_position	/soccer/football_player
/location/statistical_region/population./measurement_unit/dated_integer/source	/location/statistical_region	/dataworld/information_source
/olympics/olympic_participating_country/olympics_participated_in	/olympics/olympic_participating_country	/olympics/olympic_games
/common/annotation_category/annotations./common/webpage/topic	/common/annotation_category	/common/topic
/user/alexbl/honorary_title/titled_person/honorary_title./user/alexbl/honorary_title/honorary_title_holding/honorary_title	/user/alexbl/honorary_title/titled_person	/user/alexbl/honorary_title/honorary_title
/food/dietary_restriction/incompatible_ingredients	/food/dietary_restriction	/food/ingredient
/film/film_crewmember/films_crewed./film/film_crew_gig/film	/film/film_crewmember	/film/film
/fictional_universe/fictional_character/place_of_birth	/fictional_universe/fictional_character	/fictional_universe/fictional_setting
/base/argumentmaps/morally_disputed_activity/instance_of_abstract_moral_dispute	/base/argumentmaps/morally_disputed_activity	/base/argumentmaps/abstract_moral_dispute
/film/film/other_film_companies./film/film_film_company_relationship/film_company	/film/film	/film/film_company
/music/genre/artists	/music/genre	/music/artist
/location/country/first_level_divisions	/location/country	/location/administrative_division
/baseball/baseball_position/players	/baseball/baseball_position	/baseball/baseball_player
/broadcast/artist/content	/broadcast/artist	/broadcast/content
/government/political_party/politicians_in_this_party./government/political_party_tenure/politician	/government/political_party	/government/politician
/olympics/olympic_athlete/medals_won./olympics/olympic_medal_honor/country	/olympics/olympic_athlete	/olympics/olympic_participating_country
/location/location/street_address./location/mailing_address/state_province_region	/location/location	/location/administrative_division
/fictional_universe/character_powers/characters_with_this_ability	/fictional_universe/character_powers	/fictional_universe/fictional_character
/medicine/medical_treatment/used_to_treat	/medicine/medical_treatment	/medicine/disease
/people/person/education./education/education/institution	/people/person	/education/educational_institution
/business/business_operation/cash./measurement_unit/dated_money_value/currency	/business/business_operation	/finance/currency
/royalty/noble_person/titles./royalty/noble_title_tenure/noble_title	/royalty/noble_person	/royalty/noble_title
/base/newsevents/news_reported_event/news_report_s./base/newsevents/news_report/news_reporting_organisation	/base/newsevents/news_reported_event	/base/newsevents/news_reporting_organisation
/base/fight/crime_type/includes_crimes	/base/fight/crime_type	/base/fight/crime_type
/tv/tv_series_episode/producers./tv/tv_producer_episode_credit/producer	/tv/tv_series_episode	/tv/tv_producer
/film/personal_film_appearance_type/film_appearances./film/personal_film_appearance/film	/film/personal_film_appearance_type	/film/film
/comic_books/comic_book_series/created_by	/comic_books/comic_book_series	/comic_books/comic_book_creator
/base/patronage/patron/related_client./base/patronage/patron_client_relationship/client	/base/patronage/patron	/base/patronage/client
/base/parody/parody/parody_of	/base/parody/parody	/base/parody/parodied_subject
/media_common/dedicator/dedications./media_common/dedication/dedicated_to	/media_common/dedicator	/media_common/dedicatee
/broadcast/radio_station/owner	/broadcast/radio_station	/broadcast/radio_station_owner
/military/military_conflict/commanders./military/military_command/military_combatant	/military/military_conflict	/military/military_combatant
/people/deceased_person/place_of_burial	/people/deceased_person	/people/place_of_interment
/fictional_universe/fictional_character_creator/fictional_characters_created	/fictional_universe/fictional_character_creator	/fictional_universe/fictional_character
/tv/special_tv_performance_type/starring_performances./tv/regular_tv_appearance/actor	/tv/special_tv_performance_type	/tv/tv_actor
/music/artist/supporting_artists	/music/artist	/music/group_member
/transportation/bridge/locale	/transportation/bridge	/location/location
/music/artist/contribution./music/recording_contribution/performance_role	/music/artist	/music/performance_role
/medicine/drug/legal_status	/medicine/drug	/medicine/drug_legal_status
/book/literary_series/author_s	/book/literary_series	/book/author
/tv/tv_actor/starring_roles./tv/regular_tv_appearance/character	/tv/tv_actor	/tv/tv_character
/base/contractbridge/bridge_player/second_place_finish./base/contractbridge/bridge_tournament_standings/second_place	/base/contractbridge/bridge_player	/base/contractbridge/bridge_player
/award/award/presented_by	/award/award	/award/award_presenting_organization
/location/neighborhood/neighborhood_of	/location/neighborhood	/location/place_with_neighborhoods
/base/localfood/seasonal_month/produce_available./base/localfood/produce_availability/seasonal_months	/base/localfood/seasonal_month	/base/localfood/seasonal_month
/architecture/architect/structures_designed	/architecture/architect	/architecture/structure
/award/award_nominated_work/award_nominations./award/award_nomination/award	/award/award_nominated_work	/award/award_category
/food/diet_follower/follows_diet	/food/diet_follower	/food/diet
/religion/religion/places_of_worship	/religion/religion	/religion/place_of_worship
/travel/travel_destination/how_to_get_here./travel/transportation/transport_operator	/travel/travel_destination	/travel/transport_operator
/education/educational_institution_campus/educational_institution	/education/educational_institution_campus	/education/educational_institution
/book/author/series_written_or_contributed_to	/book/author	/book/literary_series
/award/award_winner/awards_won./award/award_honor/award_winner	/award/award_winner	/award/award_winner
/medicine/disease/risk_factors	/medicine/disease	/medicine/risk_factor
/baseball/baseball_team/current_roster./sports/sports_team_roster/player	/baseball/baseball_team	/sports/pro_athlete
/government/political_district/representatives./government/government_position_held/basic_title	/government/political_district	/government/government_office_category
/base/ecology/food_web_member/belongs_to_ecosystem_s	/base/ecology/food_web_member	/base/ecology/ecosystem
/people/ethnicity/geographic_distribution	/people/ethnicity	/location/location
/music/conducted_ensemble/conductors./music/conducting_tenure/conductor	/music/conducted_ensemble	/music/conductor
/medicine/disease/treatments	/medicine/disease	/medicine/medical_treatment
/base/popstra/celebrity/hangout./base/popstra/hangout/business_location	/base/popstra/celebrity	/base/popstra/business_location
/sports/pro_athlete/sports_played_professionally./sports/pro_sports_played/sport	/sports/pro_athlete	/sports/sport
/architecture/museum/address./location/mailing_address/citytown	/architecture/museum	/location/location
/biology/organism_classification/rank	/biology/organism_classification	/biology/organism_classification_rank
/geography/lake_type/lakes_of_this_type	/geography/lake_type	/geography/lake
/olympics/olympic_athlete/medals_won./olympics/olympic_medal_honor/olympics	/olympics/olympic_athlete	/olympics/olympic_games
/people/family_member/family	/people/family_member	/people/family
/base/petbreeds/dog_coat_color/dog_breeds	/base/petbreeds/dog_coat_color	/base/petbreeds/dog_breed
/tv/tv_program/regular_cast./tv/regular_tv_appearance/seasons	/tv/tv_program	/tv/tv_series_season
/tv/tv_program/genre	/tv/tv_program	/tv/tv_genre
/theater/play/country_of_origin	/theater/play	/location/country
/olympics/olympic_athlete/medals_won./olympics/olympic_medal_honor/medal	/olympics/olympic_athlete	/olympics/olympic_medal
/sports/sports_position/players./sports/sports_team_roster/position	/sports/sports_position	/sports/sports_position
/cvg/game_voice_actor/computer_game_voice_performances./cvg/game_performance/character	/cvg/game_voice_actor	/cvg/game_character
/biology/animal_breed/registered_with./biology/breed_registration/registry	/biology/animal_breed	/biology/breed_registry
/sports/sports_league/teams./sports/sports_league_participation/team	/sports/sports_league	/sports/sports_team
/military/rank/used_by_services./military/military_service/military_force	/military/rank	/military/armed_force
/fictional_universe/fictional_character/gender	/fictional_universe/fictional_character	/fictional_universe/character_gender
/education/school/highest_grade_taught	/education/school	/education/grade_level
/education/educational_degree/people_with_this_degree./education/education/minor	/education/educational_degree	/education/field_of_study
/baseball/baseball_team/league	/baseball/baseball_team	/baseball/baseball_league
/base/x2010fifaworldcupsouthafrica/world_cup_participant/world_cup_team./base/x2010fifaworldcupsouthafrica/current_world_cup_squad/national_team	/base/x2010fifaworldcupsouthafrica/world_cup_participant	/base/x2010fifaworldcupsouthafrica/world_cup_squad
/military/military_conflict/casualties./military/casualties/combatant	/military/military_conflict	/military/military_combatant
/computer/software/software_genre	/computer/software	/computer/software_genre
/military/armed_force/personnel./military/military_service/rank	/military/armed_force	/military/rank
/royalty/system_of_nobility/titles./royalty/system_title_relationship/title	/royalty/system_of_nobility	/royalty/noble_title
/basketball/basketball_team/roster./sports/sports_team_roster/position	/basketball/basketball_team	/sports/sports_position
/base/disaster2/tactic/attacks_of_this_form./base/disaster2/attack_process/attack_event	/base/disaster2/tactic	/base/disaster2/attack
/people/person/place_of_birth	/people/person	/location/location
/cvg/game_series/games_in_series	/cvg/game_series	/cvg/computer_videogame
/spaceflight/space_agency/astronauts	/spaceflight/space_agency	/spaceflight/astronaut
/time/event/includes_event	/time/event	/time/event
/base/aareas/schema/administrative_area/capital	/base/aareas/schema/administrative_area	/base/aareas/schema/earth/citytown
/medicine/icd_9_cm_classification/parent_classification	/medicine/icd_9_cm_classification	/medicine/icd_9_cm_classification
/people/cause_of_death/parent_cause_of_death	/people/cause_of_death	/people/cause_of_death
/education/university/domestic_tuition./measurement_unit/dated_money_value/currency	/education/university	/finance/currency
/people/profession/specialization_of	/people/profession	/people/profession
/music/musical_group/member./music/group_membership/role	/music/musical_group	/music/performance_role
/media_common/literary_genre/books_in_this_genre	/media_common/literary_genre	/book/book
/music/instrument/instrumentalists	/music/instrument	/music/group_member
/government/politician/government_positions_held./government/government_position_held/appointed_by	/government/politician	/government/political_appointer
/sports/sports_team/colors	/sports/sports_team	/visual_art/color
/religion/religious_text/religious_text_of	/religion/religious_text	/religion/religion
/organization/role/leaders./organization/leadership/person	/organization/role	/business/board_member
/fictional_universe/fictional_setting/fictional_characters_born_here	/fictional_universe/fictional_setting	/fictional_universe/fictional_character
/film/production_company/films	/film/production_company	/film/film
/sports/sports_award_winner/awards./sports/sports_award/award	/sports/sports_award_winner	/sports/sports_award_type
/base/argumentmaps/abstract_moral_dispute/particular_instances	/base/argumentmaps/abstract_moral_dispute	/base/argumentmaps/morally_disputed_activity
/people/person/sibling_s./people/sibling_relationship/sibling	/people/person	/people/person
/influence/influence_node/influenced	/influence/influence_node	/influence/influence_node
/book/newspaper_owner/newspapers_owned	/book/newspaper_owner	/book/newspaper
/geography/river/basin_countries	/geography/river	/location/country
/film/person_or_entity_appearing_in_film/films./film/personal_film_appearance/film	/film/person_or_entity_appearing_in_film	/film/film
/royalty/order_of_chivalry/recipients./royalty/chivalric_order_membership/recipient	/royalty/order_of_chivalry	/royalty/chivalric_order_member
/visual_art/art_period_movement/associated_artists	/visual_art/art_period_movement	/visual_art/visual_artist
/film/film/dubbing_performances./film/dubbing_performance/actor	/film/film	/film/actor
/user/szaijan/fantasy_football/player/nfl_team	/user/szaijan/fantasy_football/player	/american_football/football_team
/base/contractbridge/bridge_player/second_place_finish./base/contractbridge/bridge_tournament_standings/first_place	/base/contractbridge/bridge_player	/base/contractbridge/bridge_player
/military/armed_force/personnel./military/military_service/military_person	/military/armed_force	/military/military_person
/organization/organization/board_members./organization/organization_board_membership/role	/organization/organization	/organization/role
/location/it_province/capital	/location/it_province	/location/it_comune
/base/contractbridge/bridge_player/first_place_finish./base/contractbridge/bridge_tournament_standings/second_place	/base/contractbridge/bridge_player	/base/contractbridge/bridge_player
/common/webpage/category	/common/webpage	/common/annotation_category
/medicine/type_of_infectious_agent/diseases	/medicine/type_of_infectious_agent	/medicine/infectious_disease
/book/newspaper/owner	/book/newspaper	/book/newspaper_owner
/architecture/building/building_function	/architecture/building	/architecture/building_function
/time/recurring_event/instances	/time/recurring_event	/time/event
/base/crime/crime_victim/crime	/base/crime/crime_victim	/base/crime/crime
/american_football/football_coach/coaching_history./american_football/football_historical_coach_position/team	/american_football/football_coach	/american_football/football_team
/sports/sports_league_draft/picks./sports/sports_league_draft_pick/team	/sports/sports_league_draft	/sports/professional_sports_team
/base/contractbridge/bridge_player/teammates./base/contractbridge/bridge_player_teammates/teammate	/base/contractbridge/bridge_player	/base/contractbridge/bridge_player
/architecture/architectural_style/examples	/architecture/architectural_style	/architecture/structure
/cvg/computer_videogame/characters./cvg/game_performance/voice_actor	/cvg/computer_videogame	/cvg/game_voice_actor
/olympics/olympic_games/athletes./olympics/olympic_athlete_affiliation/sport	/olympics/olympic_games	/olympics/olympic_sport
/internet/website_owner/websites_owned_new./internet/website_ownership/website	/internet/website_owner	/internet/website
/olympics/olympic_athlete/country./olympics/olympic_athlete_affiliation/olympics	/olympics/olympic_athlete	/olympics/olympic_games
/film/film/release_date_s./film/film_regional_release_date/film_regional_debut_venue	/film/film	/film/film_screening_venue
/base/biblioness/bibs_location/country	/base/biblioness/bibs_location	/location/location
/organization/organization/spun_off_from./organization/organization_spin_off/parent_company	/organization/organization	/organization/organization
/government/government_office_or_title/category	/government/government_office_or_title	/government/government_office_category
/aviation/airport/hub_for	/aviation/airport	/aviation/airline
/cvg/cvg_publisher/games_published	/cvg/cvg_publisher	/cvg/computer_videogame
/government/legislative_session/members./government/government_position_held/basic_title	/government/legislative_session	/government/government_office_category
/base/wrestling/solo_wrestler_or_team/members	/base/wrestling/solo_wrestler_or_team	/base/wrestling/professional_wrestler
/government/government_office_or_title/office_holders./government/government_position_held/appointed_by	/government/government_office_or_title	/government/political_appointer
/tv/tv_actor/starring_roles./tv/regular_tv_appearance/series	/tv/tv_actor	/tv/tv_program
/education/educational_institution/students_graduates./education/education/major_field_of_study	/education/educational_institution	/education/field_of_study
/user/alexander/misc/murdered_person/place_murdered	/user/alexander/misc/murdered_person	/location/location
/base/saints/saint/venerated_in	/base/saints/saint	/religion/religion
/film/film/gross_revenue./measurement_unit/dated_money_value/currency	/film/film	/finance/currency
/film/film_character/portrayed_in_films./film/performance/special_performance_type	/film/film_character	/film/special_film_performance_type
/organization/organization/leadership./organization/leadership/role	/organization/organization	/organization/role
/base/nobelprizes/nobel_subject_area/nobel_awards./base/nobelprizes/nobel_honor/nobel_prize_winner	/base/nobelprizes/nobel_subject_area	/base/nobelprizes/nobel_prize_winner
/tv/special_tv_performance_type/episode_performances./tv/tv_guest_role/actor	/tv/special_tv_performance_type	/tv/tv_actor
/base/americancomedy/celebrity_impressionist/celebrities_impersonated	/base/americancomedy/celebrity_impressionist	/base/americancomedy/impersonated_celebrity
/base/activism/organization/area_of_activism	/base/activism/organization	/base/activism/activism_issue
/organization/organization/involved_in_merger./organization/organization_merger/became_organization	/organization/organization	/organization/organization
/fictional_universe/character_gender/characters_of_this_gender	/fictional_universe/character_gender	/fictional_universe/fictional_character
/people/ethnicity/included_in_group	/people/ethnicity	/people/ethnicity
/baseball/baseball_player/position_s	/baseball/baseball_player	/baseball/baseball_position
/american_football/football_coach_position/coaches_holding_this_position./american_football/football_historical_coach_position/team	/american_football/football_coach_position	/american_football/football_team
/base/popstra/restaurant/restaurant_choice./base/popstra/restaurant_choice/diner	/base/popstra/restaurant	/base/popstra/celebrity
/baseball/baseball_team/current_roster./sports/sports_team_roster/position	/baseball/baseball_team	/sports/sports_position
/base/popstra/company/fashion_choice./base/popstra/fashion_choice/fashion_wearer	/base/popstra/company	/base/popstra/celebrity
/location/country/second_level_divisions	/location/country	/location/administrative_division
/sports/professional_sports_team/draft_picks./sports/sports_league_draft_pick/player	/sports/professional_sports_team	/sports/drafted_athlete
/fictional_universe/fictional_character/ethnicity	/fictional_universe/fictional_character	/fictional_universe/ethnicity_in_fiction
/sports/sports_team/location	/sports/sports_team	/sports/sports_team_location
/soccer/football_player/goals_scored./soccer/football_goal/point_awarded_to	/soccer/football_player	/soccer/football_team
/base/onephylogeny/type_of_thing/things_of_this_type	/base/onephylogeny/type_of_thing	/common/topic
/music/voice/singers	/music/voice	/music/group_member
/film/film/distributors./film/film_film_distributor_relationship/distributor	/film/film	/film/film_distributor
/religion/religion/notable_figures	/religion/religion	/people/person
/influence/influence_node/peers./influence/peer_relationship/peers	/influence/influence_node	/influence/influence_node
/user/robert/us_congress/house_committee/current_members	/user/robert/us_congress/house_committee	/user/robert/us_congress/us_representative
/sports/drafted_athlete/drafted./sports/sports_league_draft_pick/school	/sports/drafted_athlete	/education/educational_institution
/fictional_universe/character_rank/characters_of_this_rank	/fictional_universe/character_rank	/fictional_universe/fictional_character
/comic_books/comic_book_series/featured_characters	/comic_books/comic_book_series	/comic_books/comic_book_character
/cvg/computer_videogame/designers	/cvg/computer_videogame	/cvg/cvg_designer
/medicine/risk_factor/diseases	/medicine/risk_factor	/medicine/disease
/award/award_category/long_lists./award/long_list_nomination/nominee	/award/award_category	/award/long_list_nominee
/medicine/drug/active_moieties	/medicine/drug	/medicine/drug_ingredient
/film/film/music	/film/film	/film/music_contributor
/martial_arts/martial_artist/martial_art	/martial_arts/martial_artist	/martial_arts/martial_art
/location/statistical_region/rent50_0./measurement_unit/dated_money_value/currency	/location/statistical_region	/finance/currency
/base/schemastaging/tv_program_extra/regular_dubbing_performances./base/schemastaging/tv_star_dubbing_performance/language	/base/schemastaging/tv_program_extra	/language/human_language
/people/person/spouse_s./people/marriage/location_of_ceremony	/people/person	/location/location
/visual_art/visual_artist/associated_periods_or_movements	/visual_art/visual_artist	/visual_art/art_period_movement
/architecture/building_function/buildings	/architecture/building_function	/architecture/building
/book/school_or_movement/associated_authors	/book/school_or_movement	/book/author
/theater/theater_character/portrayed_by./theater/theater_role/actor	/theater/theater_character	/theater/theater_actor
/biology/animal_breed/registered_with./biology/breed_registration/breed_group	/biology/animal_breed	/biology/breed_group
/common/topic/webpage./common/webpage/topic	/common/topic	/common/topic
/cvg/computer_videogame/publisher	/cvg/computer_videogame	/cvg/cvg_publisher
/government/politician/government_positions_held./government/government_position_held/governmental_body	/government/politician	/government/governmental_body
/music/group_member/vocal_range	/music/group_member	/music/voice
/biology/organism_classification/higher_classification	/biology/organism_classification	/biology/organism_classification
/education/educational_institution/students_graduates./education/education/degree	/education/educational_institution	/education/educational_degree
/astronomy/celestial_object/category	/astronomy/celestial_object	/astronomy/celestial_object_category
/people/person/religion	/people/person	/religion/religion
/user/coco/science/concepts_theories/parent_concept	/user/coco/science/concepts_theories	/user/coco/science/concepts_theories
/sports/tournament_event_competitor/events_competed_in./sports/competitor_competition_relationship/country	/sports/tournament_event_competitor	/sports/sport_country
/film/cinematographer/film	/film/cinematographer	/film/film
/base/famouspets/pet_owner/pets_owned./base/famouspets/pet_ownership/owner	/base/famouspets/pet_owner	/base/famouspets/pet_owner
/people/person/employment_history./business/employment_tenure/title	/people/person	/business/job_title
/tv/tv_program_guest/appeared_on./tv/tv_guest_personal_appearance/episode	/tv/tv_program_guest	/tv/tv_series_episode
/location/statistical_region/gni_in_ppp_dollars./measurement_unit/dated_money_value/currency	/location/statistical_region	/finance/currency
/base/fight/sports_official/sport	/base/fight/sports_official	/sports/sport
/base/popstra/celebrity/breakup./base/popstra/breakup/participant	/base/popstra/celebrity	/base/popstra/celebrity
/location/location/partially_contains	/location/location	/location/location
/people/person/spouse_s./people/marriage/spouse	/people/person	/people/person
/base/popstra/celebrity/vacations_in./base/popstra/vacation_choice/location	/base/popstra/celebrity	/base/popstra/location
/olympics/olympic_participating_country/athletes./olympics/olympic_athlete_affiliation/athlete	/olympics/olympic_participating_country	/olympics/olympic_athlete
/aviation/airline/airports_served./aviation/airline_airport_presence/cities_served	/aviation/airline	/location/citytown
/dining/cuisine/dishes	/dining/cuisine	/food/dish
/olympics/olympic_sport/athletes./olympics/olympic_athlete_affiliation/country	/olympics/olympic_sport	/olympics/olympic_participating_country
/location/symbol_of_administrative_division/official_symbol_of./location/location_symbol_relationship/administrative_division	/location/symbol_of_administrative_division	/government/governmental_jurisdiction
/business/business_operation/assets./measurement_unit/dated_money_value/currency	/business/business_operation	/finance/currency
/tv/tv_program/regular_cast./tv/regular_tv_appearance/actor	/tv/tv_program	/tv/tv_actor
/book/magazine_genre/magazines_in_this_genre	/book/magazine_genre	/book/magazine
/base/schemastaging/tv_program_extra/regular_dubbing_performances./base/schemastaging/tv_star_dubbing_performance/character	/base/schemastaging/tv_program_extra	/base/schemastaging/tv_character_extra
/government/legislative_session/members./government/government_position_held/office_holder	/government/legislative_session	/government/politician
/base/americancomedy/comedy_genre/comedians_in_this_genre	/base/americancomedy/comedy_genre	/base/americancomedy/comedian
/film/film_art_director/films_art_directed	/film/film_art_director	/film/film
/education/academic_institution/visiting_scholars_fellows_etc./education/academic_post/person	/education/academic_institution	/education/academic
/business/employer/employees./business/employment_tenure/title	/business/employer	/business/job_title
/olympics/olympic_sport/athletes./olympics/olympic_athlete_affiliation/olympics	/olympics/olympic_sport	/olympics/olympic_games
/baseball/baseball_player/batting_stats./baseball/batting_statistics/season	/baseball/baseball_player	/sports/sports_league_season
/education/school_category/schools_of_this_kind	/education/school_category	/education/educational_institution
/music/artist/track_contributions./music/track_contribution/role	/music/artist	/music/performance_role
/base/localfood/food_producing_region/seasonal_availability./base/localfood/produce_availability/produce	/base/localfood/food_producing_region	/base/localfood/produce
/protected_sites/listed_site/designation_as_natural_or_cultural_site./protected_sites/natural_or_cultural_site_listing/designation	/protected_sites/listed_site	/protected_sites/natural_or_cultural_site_designation
/military/military_conflict/combatants./military/military_combatant_group/combatants	/military/military_conflict	/military/military_combatant
/tv/tv_producer_type/tv_producers_of_this_type./tv/tv_producer_term/producer	/tv/tv_producer_type	/tv/tv_producer
/education/field_of_study/students_majoring./education/education/specialization	/education/field_of_study	/education/field_of_study
/film/film/production_companies	/film/film	/film/production_company
/base/saturdaynightlive/snl_cast_member/seasons./base/saturdaynightlive/snl_season_tenure/cast_members	/base/saturdaynightlive/snl_cast_member	/base/saturdaynightlive/snl_cast_member
/computer/programming_language/language_designers	/computer/programming_language	/computer/programming_language_designer
/base/americancomedy/comedy_group_member/belongs_to./base/americancomedy/comedy_group_membership/group	/base/americancomedy/comedy_group_member	/base/americancomedy/comedy_group
/location/place_with_neighborhoods/neighborhoods	/location/place_with_neighborhoods	/location/neighborhood
/education/university/fraternities_and_sororities	/education/university	/education/fraternity_sorority
/base/usnationalparks/us_national_park/state	/base/usnationalparks/us_national_park	/location/location
/base/contractbridge/bridge_player/first_place_finish./base/contractbridge/bridge_tournament_standings/tournament	/base/contractbridge/bridge_player	/base/contractbridge/bridge_tournament
/education/educational_institution/students_graduates./education/education/specialization	/education/educational_institution	/education/field_of_study
/location/statistical_region/rent50_1./measurement_unit/dated_money_value/currency	/location/statistical_region	/finance/currency
/base/contractbridge/bridge_tournament/standing./base/contractbridge/bridge_tournament_standings/first_place	/base/contractbridge/bridge_tournament	/base/contractbridge/bridge_player
/government/politician/government_positions_held./government/government_position_held/district_represented	/government/politician	/government/political_district
/government/governmental_body/members./government/government_position_held/appointed_by	/government/governmental_body	/government/political_appointer
/user/tfmorris/default_domain/signatory/documents_signed	/user/tfmorris/default_domain/signatory	/user/tfmorris/default_domain/document
/geography/island/body_of_water	/geography/island	/geography/body_of_water
/location/country/form_of_government	/location/country	/government/form_of_government
/film/special_film_performance_type/film_performance_type./film/performance/film	/film/special_film_performance_type	/film/film
/base/aareas/schema/administrative_area/administrative_children	/base/aareas/schema/administrative_area	/base/aareas/schema/administrative_area
/film/music_contributor/film	/film/music_contributor	/film/film
/government/politician/government_positions_held./government/government_position_held/basic_title	/government/politician	/government/government_office_category
/fictional_universe/fictional_character/appears_in_these_fictional_universes	/fictional_universe/fictional_character	/fictional_universe/fictional_universe
/government/election/office	/government/election	/government/government_office_or_title
/user/robert/us_congress/us_representative/committee_memberships	/user/robert/us_congress/us_representative	/user/robert/us_congress/house_committee
/education/university/local_tuition./measurement_unit/dated_money_value/currency	/education/university	/finance/currency
/education/educational_institution/sports_teams	/education/educational_institution	/sports/school_sports_team
/food/dish/cuisine	/food/dish	/dining/cuisine
/military/military_combatant/military_commanders./military/military_command/military_conflict	/military/military_combatant	/military/military_conflict
/aviation/aircraft_type/aircraft_of_this_type	/aviation/aircraft_type	/aviation/aircraft_model
/base/events/festival_series/type_of_festival	/base/events/festival_series	/base/events/type_of_festival
/basketball/basketball_player/player_statistics./basketball/basketball_player_stats/team	/basketball/basketball_player	/basketball/basketball_team
/business/brand/owner_s./business/company_brand_relationship/company	/business/brand	/business/consumer_company
/award/award_winner/awards_won./award/award_honor/ceremony	/award/award_winner	/award/award_ceremony
/base/events/performer/performances./base/events/performance/performer	/base/events/performer	/base/events/performer
/aviation/airline/focus_cities	/aviation/airline	/aviation/airport
/base/events/type_of_festival/recurring_festivals_of_this_type	/base/events/type_of_festival	/base/events/festival_series
/military/military_combatant/force_deployments./military/force_strength/military_conflict	/military/military_combatant	/military/military_conflict
/american_football/football_team/current_roster./sports/sports_team_roster/player	/american_football/football_team	/sports/pro_athlete
/education/educational_institution/mascot	/education/educational_institution	/education/school_mascot
/film/film/film_casting_director	/film/film	/film/film_casting_director
/olympics/olympic_sport/olympic_games_contested	/olympics/olympic_sport	/olympics/olympic_games
/base/fight/crime_type/included_in_crimes	/base/fight/crime_type	/base/fight/crime_type
/business/asset/owners./business/asset_ownership/owner	/business/asset	/business/asset_owner
/tennis/tennis_player/matches_won./tennis/tennis_match/loser	/tennis/tennis_player	/tennis/tennis_player
/geography/lake/cities	/geography/lake	/location/citytown
/soccer/football_team/current_roster./sports/sports_team_roster/position	/soccer/football_team	/sports/sports_position
/film/film/directed_by	/film/film	/film/director
/computer/programming_language/dialects	/computer/programming_language	/computer/programming_language
/award/award_ceremony/awards_presented./award/award_honor/award	/award/award_ceremony	/award/award_category
/location/statistical_region/gdp_real./measurement_unit/adjusted_money_value/adjustment_currency	/location/statistical_region	/finance/currency
/visual_art/visual_art_form/artists	/visual_art/visual_art_form	/visual_art/visual_artist
/organization/organization/parent./organization/organization_relationship/parent	/organization/organization	/organization/organization
/base/thoroughbredracing/thoroughbred_racehorse_origin/horses_from_this_location	/base/thoroughbredracing/thoroughbred_racehorse_origin	/base/thoroughbredracing/thoroughbred_racehorse
/olympics/olympic_medal/medal_winners./olympics/olympic_medal_honor/country	/olympics/olympic_medal	/olympics/olympic_participating_country
/medicine/medical_treatment/side_effects	/medicine/medical_treatment	/medicine/symptom
/base/popstra/celebrity/eats_at./base/popstra/restaurant_choice/restaurant	/base/popstra/celebrity	/base/popstra/restaurant
/tv/tv_program/spun_off_from	/tv/tv_program	/tv/tv_program
/business/business_operation/industry	/business/business_operation	/business/industry
/education/educational_institution/parent_institution	/education/educational_institution	/education/educational_institution
/film/film_set_designer/film_sets_designed	/film/film_set_designer	/film/film
/tv/non_character_role/tv_regular_personal_appearances./tv/tv_regular_personal_appearance/program	/tv/non_character_role	/tv/tv_program
/education/school/lowest_grade_taught	/education/school	/education/grade_level
/film/film_company/films./film/film_film_company_relationship/film	/film/film_company	/film/film
/base/americancomedy/comedian/comedy_genres	/base/americancomedy/comedian	/base/americancomedy/comedy_genre
/government/politician/government_positions_held./government/government_position_held/legislative_sessions	/government/politician	/government/legislative_session
/medicine/disease/causes	/medicine/disease	/medicine/disease_cause
/film/special_film_performance_type/film_performance_type./film/performance/character	/film/special_film_performance_type	/film/film_character
/government/governmental_jurisdiction/government_positions	/government/governmental_jurisdiction	/government/government_office_or_title
/medicine/drug/drug_class	/medicine/drug	/medicine/drug_class
/government/governmental_body/members./government/government_position_held/district_represented	/government/governmental_body	/government/political_district
/tv/tv_character/appeared_in_tv_program./tv/regular_tv_appearance/special_performance_type	/tv/tv_character	/tv/special_tv_performance_type
/religion/deity/deity_of	/religion/deity	/religion/religion
/film/film/prequel	/film/film	/film/film
/base/argumentmaps/original_idea/innovator	/base/argumentmaps/original_idea	/base/argumentmaps/innovator
/tv/tv_subject/tv_programs	/tv/tv_subject	/tv/tv_program
/award/award_presenting_organization/awards_presented	/award/award_presenting_organization	/award/award
/tv/tv_actor/starring_roles./tv/regular_tv_appearance/seasons	/tv/tv_actor	/tv/tv_series_season
/book/newspaper/circulation_areas	/book/newspaper	/periodicals/newspaper_circulation_area
/film/film/written_by	/film/film	/film/writer
/tv/tv_program/spin_offs	/tv/tv_program	/tv/tv_program
/tv/tv_actor/guest_roles./tv/tv_guest_role/character	/tv/tv_actor	/tv/tv_character
/sports/sports_league/sport	/sports/sports_league	/sports/sport
/location/location/containedby	/location/location	/location/location
/organization/role/governors./organization/organization_board_membership/organization	/organization/role	/organization/organization
/baseball/baseball_player/lifetime_batting_statistics./baseball/lifetime_batting_statistics/starting_season	/baseball/baseball_player	/sports/sports_league_season
/travel/transport_operator/travel_destinations_served./travel/transportation/travel_destination	/travel/transport_operator	/travel/travel_destination
/location/location/time_zones	/location/location	/time/time_zone
/computer/programming_language_designer/languages_designed	/computer/programming_language_designer	/computer/programming_language
/music/album_release_type/albums	/music/album_release_type	/music/album
/award/award_discipline/awards_in_this_discipline	/award/award_discipline	/award/award_category
/people/ethnicity/people	/people/ethnicity	/people/person
/periodicals/newspaper_circulation_area/newspapers	/periodicals/newspaper_circulation_area	/book/newspaper
/people/profession/specializations	/people/profession	/people/profession
/government/political_appointer/appointees./government/government_position_held/office_holder	/government/political_appointer	/government/politician
/user/robert/us_congress/us_representative/state	/user/robert/us_congress/us_representative	/location/us_state
/film/film/subjects	/film/film	/film/film_subject
/book/newspaper/headquarters./location/mailing_address/citytown	/book/newspaper	/location/location
/film/film_production_designer/films_production_designed	/film/film_production_designer	/film/film
/computer/software_genre/software_in_genre	/computer/software_genre	/computer/software
/celebrities/celebrity/celebrity_friends./celebrities/friendship/friend	/celebrities/celebrity	/celebrities/celebrity
/protected_sites/natural_or_cultural_site_designation/sites./protected_sites/natural_or_cultural_site_listing/listed_site	/protected_sites/natural_or_cultural_site_designation	/protected_sites/listed_site
/business/employer/employees./business/employment_tenure/person	/business/employer	/people/person
/tv/tv_series_season/regular_cast./tv/regular_tv_appearance/seasons	/tv/tv_series_season	/tv/tv_series_season
/olympics/olympic_participating_country/medals_won./olympics/olympic_medal_honor/medal	/olympics/olympic_participating_country	/olympics/olympic_medal
/organization/organization/headquarters./location/mailing_address/country	/organization/organization	/location/country
/music/conductor/groups./music/conducting_tenure/ensemble	/music/conductor	/music/conducted_ensemble
/common/resource/annotations./common/webpage/category	/common/resource	/common/annotation_category
/base/fashionmodels/fashion_model/hair_color	/base/fashionmodels/fashion_model	/base/fashionmodels/hair_color
/education/educational_degree/people_with_this_degree./education/education/student	/education/educational_degree	/people/person
/projects/project_role/projects./projects/project_participation/participant	/projects/project_role	/projects/project_participant
/biology/organism_classification_rank/organism_classifications	/biology/organism_classification_rank	/biology/organism_classification
/base/popstra/celebrity/lived_with./base/popstra/lived_with/participant	/base/popstra/celebrity	/base/popstra/celebrity
/user/szaijan/fantasy_football/position/player	/user/szaijan/fantasy_football/position	/user/szaijan/fantasy_football/player
/tv/tv_writer/tv_programs./tv/tv_program_writer_relationship/tv_program	/tv/tv_writer	/tv/tv_program
/theater/theater_genre/plays_in_this_genre	/theater/theater_genre	/theater/play
/government/governmental_body/members./government/government_position_held/office_holder	/government/governmental_body	/government/politician
/award/award_winning_work/awards_won./award/award_honor/ceremony	/award/award_winning_work	/award/award_ceremony
/religion/religion/is_part_of	/religion/religion	/religion/religion
/film/producer/film	/film/producer	/film/film
/tv/tv_producer/programs_produced./tv/tv_producer_term/program	/tv/tv_producer	/tv/tv_program
/base/twinnedtowns/twinned_town/twinned_with./base/twinnedtowns/town_twinning/twinned_towns	/base/twinnedtowns/twinned_town	/base/twinnedtowns/twinned_town
/transportation/road/end1./transportation/road_starting_point/location	/transportation/road	/location/location
/base/parody/parodied_subject/parodies	/base/parody/parodied_subject	/base/parody/parody
/government/government_office_or_title/governmental_body_if_any	/government/government_office_or_title	/government/governmental_body
/language/language_family/languages	/language/language_family	/language/human_language
/tv/tv_program/program_creator	/tv/tv_program	/tv/tv_program_creator
/music/performance_role/regular_performances./music/group_membership/group	/music/performance_role	/music/musical_group
/education/field_of_study/subdiscipline_of	/education/field_of_study	/education/field_of_study
/music/performance_role/track_performances./music/track_contribution/role	/music/performance_role	/music/performance_role
/broadcast/tv_station_owner/tv_stations	/broadcast/tv_station_owner	/broadcast/tv_station
/base/schemastaging/organization_extra/phone_number./base/schemastaging/phone_sandbox/service_language	/base/schemastaging/organization_extra	/language/human_language
/business/industry/companies	/business/industry	/business/business_operation
/base/schemastaging/tv_actor_extra/regular_dubbing_performances./base/schemastaging/tv_star_dubbing_performance/language	/base/schemastaging/tv_actor_extra	/language/human_language
/award/award_winning_work/awards_won./award/award_honor/honored_for	/award/award_winning_work	/award/award_winning_work
/business/board_member/leader_of./organization/leadership/organization	/business/board_member	/organization/organization
/education/university/international_tuition./measurement_unit/dated_money_value/currency	/education/university	/finance/currency
/fictional_universe/fictional_character/occupation	/fictional_universe/fictional_character	/fictional_universe/character_occupation
/base/schemastaging/athlete_extra/salary./base/schemastaging/athlete_salary/team	/base/schemastaging/athlete_extra	/base/schemastaging/sports_team_extra
/organization/organization/acquired_by./business/acquisition/acquiring_company	/organization/organization	/organization/organization
/baseball/baseball_team/historical_roster./sports/sports_team_roster/player	/baseball/baseball_team	/sports/pro_athlete
/music/group_member/membership./music/group_membership/role	/music/group_member	/music/performance_role
/location/us_county/hud_county_place	/location/us_county	/location/hud_county_place
/base/yalebase/secret_society/notable_members./base/yalebase/secret_society_membership/member	/base/yalebase/secret_society	/base/yalebase/secret_society_member
/base/rugby/rugby_player/type_of_rugby	/base/rugby/rugby_player	/base/rugby/type_of_rugby
/location/hud_foreclosure_area/estimated_number_of_mortgages./measurement_unit/dated_integer/source	/location/hud_foreclosure_area	/dataworld/information_source
/aviation/airline/airports_served./aviation/airline_airport_presence/airport	/aviation/airline	/aviation/airport
/medicine/drug_ingredient/more_general_ingredient	/medicine/drug_ingredient	/medicine/drug_ingredient
/film/film/distributors./film/film_film_distributor_relationship/region	/film/film	/location/location
/fictional_universe/person_in_fiction/representations_in_fiction	/fictional_universe/person_in_fiction	/fictional_universe/fictional_character
/base/locations/continents/countries_within	/base/locations/continents	/base/locations/countries
/people/person/education./education/education/major_field_of_study	/people/person	/education/field_of_study
/award/award_winning_work/awards_won./award/award_honor/award	/award/award_winning_work	/award/award_category
/music/artist/album	/music/artist	/music/album
/cvg/computer_game_subject/games	/cvg/computer_game_subject	/cvg/computer_videogame
/tv/tv_personality/tv_regular_appearances./tv/tv_regular_personal_appearance/appearance_type	/tv/tv_personality	/tv/non_character_role
/aviation/aircraft_owner/aircraft_fleet_composition./aviation/aircraft_ownership_count/aircraft_model	/aviation/aircraft_owner	/aviation/aircraft_model
/military/military_commander/military_commands./military/military_command/military_conflict	/military/military_commander	/military/military_conflict
/education/school/school_district	/education/school	/education/school_district
/fictional_universe/fictional_character/children	/fictional_universe/fictional_character	/fictional_universe/fictional_character
/tv/tv_series_season/regular_cast./tv/regular_tv_appearance/series	/tv/tv_series_season	/tv/tv_program
/computer/software/license	/computer/software	/computer/software_license
/broadcast/tv_station/owner	/broadcast/tv_station	/broadcast/tv_station_owner
/architecture/museum/type_of_museum	/architecture/museum	/architecture/type_of_museum
/award/recurring_competition/individual_competitions	/award/recurring_competition	/award/competition
/people/profession/people_with_this_profession	/people/profession	/people/person
/fictional_universe/fictional_character/character_created_by	/fictional_universe/fictional_character	/fictional_universe/fictional_character_creator
/base/endorsements/endorsee/newspaper_endorsements./base/endorsements/newspaper_endorsement/newspaper	/base/endorsements/endorsee	/base/endorsements/endorsing_newspaper
/film/writer/film	/film/writer	/film/film
/tv/tv_producer_type/tv_producers_of_this_type./tv/tv_producer_term/program	/tv/tv_producer_type	/tv/tv_program
/location/hud_foreclosure_area/hhuniv./measurement_unit/dated_integer/source	/location/hud_foreclosure_area	/dataworld/information_source
/military/military_conflict/commanders./military/military_command/military_commander	/military/military_conflict	/military/military_commander
/music/artist/genre	/music/artist	/music/genre
/food/dietary_restriction/compatible_ingredients	/food/dietary_restriction	/food/ingredient
/tv/tv_program/regular_personal_appearances./tv/tv_regular_personal_appearance/appearance_type	/tv/tv_program	/tv/non_character_role
/award/award_category/winners./award/award_honor/ceremony	/award/award_category	/award/award_ceremony
/computer/computer/manufacturer	/computer/computer	/computer/computer_manufacturer_brand
/government/governmental_jurisdiction/governing_officials./government/government_position_held/office_holder	/government/governmental_jurisdiction	/government/politician
/religion/religious_practice/practice_of	/religion/religious_practice	/religion/religion
/music/genre/albums	/music/genre	/music/album
/government/governmental_jurisdiction/official_symbols./location/location_symbol_relationship/symbol	/government/governmental_jurisdiction	/location/symbol_of_administrative_division
/organization/organization/phone_number./common/phone_number/category	/organization/organization	/organization/contact_category
/base/activism/activism_issue/activists	/base/activism/activism_issue	/base/activism/activist
/base/endorsements/endorsing_newspaper/endorsements./base/endorsements/newspaper_endorsement/election	/base/endorsements/endorsing_newspaper	/government/election
/government/political_district/representatives./government/government_position_held/office_holder	/government/political_district	/government/politician
/music/performance_role/regular_performances./music/group_membership/role	/music/performance_role	/music/performance_role
/common/webpage/topic	/common/webpage	/common/topic
/tennis/tennis_player/matches_lost./tennis/tennis_match/winner	/tennis/tennis_player	/tennis/tennis_player
/basketball/basketball_team/historical_roster./sports/sports_team_roster/player	/basketball/basketball_team	/sports/pro_athlete
/location/location/partially_containedby	/location/location	/location/location
/location/statistical_region/religions./location/religion_percentage/religion	/location/statistical_region	/religion/religion
/government/governmental_body/members./government/government_position_held/legislative_sessions	/government/governmental_body	/government/legislative_session
/tv/tv_series_season/series	/tv/tv_series_season	/tv/tv_program
/cvg/computer_videogame/cvg_genre	/cvg/computer_videogame	/cvg/cvg_genre
/government/governmental_jurisdiction/governing_officials./government/government_position_held/office_position_or_title	/government/governmental_jurisdiction	/government/government_office_or_title
/transportation/road/end2./transportation/road_starting_point/location	/transportation/road	/location/location
/military/military_person/service./military/military_service/military_force	/military/military_person	/military/armed_force
/american_football/football_team/historical_roster./sports/sports_team_roster/position	/american_football/football_team	/sports/sports_position
/people/appointer/appointment_made./people/appointment/appointed_role	/people/appointer	/people/appointed_role
/government/political_district/representatives./government/government_position_held/jurisdiction_of_office	/government/political_district	/government/governmental_jurisdiction
/user/coco/science/concepts_theories/child_concept	/user/coco/science/concepts_theories	/user/coco/science/concepts_theories
/fictional_universe/fictional_character/romantically_involved_with./fictional_universe/romantic_involvement/partner	/fictional_universe/fictional_character	/fictional_universe/fictional_character
/military/military_combatant/military_conflicts./military/military_combatant_group/combatants	/military/military_combatant	/military/military_combatant
/base/popstra/business_location/customer./base/popstra/hangout/customer	/base/popstra/business_location	/base/popstra/celebrity
/base/activism/activism_issue/activist_organizations	/base/activism/activism_issue	/base/activism/organization
/base/contractbridge/bridge_player/second_place_finish./base/contractbridge/bridge_tournament_standings/tournament	/base/contractbridge/bridge_player	/base/contractbridge/bridge_tournament
/base/patronage/client/related_patron./base/patronage/patron_client_relationship/patron	/base/patronage/client	/base/patronage/patron
/people/ethnicity/languages_spoken	/people/ethnicity	/language/human_language
/internet/website_category/sites	/internet/website_category	/internet/website
/people/appointer/appointment_made./people/appointment/appointee	/people/appointer	/people/appointee
/award/award_category/presenting_organization	/award/award_category	/award/award_presenting_organization
/biology/organism_classification/organisms_of_this_type	/biology/organism_classification	/biology/organism
/film/actor/film./film/performance/character	/film/actor	/film/film_character
/government/politician/party./government/political_party_tenure/party	/government/politician	/government/political_party
/american_football/football_player/games./american_football/player_game_statistics/team	/american_football/football_player	/american_football/football_team
/base/schemastaging/tv_actor_extra/regular_dubbing_performances./base/schemastaging/tv_star_dubbing_performance/character	/base/schemastaging/tv_actor_extra	/base/schemastaging/tv_character_extra
/language/human_language/region	/language/human_language	/location/location
/user/lindenb/default_domain/scientist/known_for	/user/lindenb/default_domain/scientist	/common/topic
/fictional_universe/fictional_character/siblings./fictional_universe/sibling_relationship_of_fictional_characters/siblings	/fictional_universe/fictional_character	/fictional_universe/fictional_character
/people/person/profession	/people/person	/people/profession
/computer/software/developer	/computer/software	/computer/software_developer
/user/alexander/philosophy/philosopher/interests	/user/alexander/philosophy/philosopher	/user/alexander/philosophy/subject
/government/government_office_category/officeholders./government/government_position_held/office_position_or_title	/government/government_office_category	/government/government_office_or_title
/government/governmental_body/offices_positions	/government/governmental_body	/government/government_office_or_title
/american_football/football_team/historical_roster./sports/sports_team_roster/player	/american_football/football_team	/sports/pro_athlete
/film/film_story_contributor/film_story_credits	/film/film_story_contributor	/film/film
/user/alexander/philosophy/era/philosophers	/user/alexander/philosophy/era	/user/alexander/philosophy/philosopher
/film/producer/films_executive_produced	/film/producer	/film/film
/visual_art/artwork/art_subject	/visual_art/artwork	/visual_art/art_subject
/visual_art/visual_artist/art_forms	/visual_art/visual_artist	/visual_art/visual_art_form
/american_football/football_coach_position/coaches_holding_this_position./american_football/football_historical_coach_position/coach	/american_football/football_coach_position	/american_football/football_coach
/location/hud_foreclosure_area/estimated_number_foreclosures./measurement_unit/dated_integer/source	/location/hud_foreclosure_area	/dataworld/information_source
/film/film_format/film_format	/film/film_format	/film/film
/government/political_district/representatives./government/government_position_held/legislative_sessions	/government/political_district	/government/legislative_session
/broadcast/content/genre	/broadcast/content	/broadcast/genre
/sports/sports_team_owner/teams_owned	/sports/sports_team_owner	/sports/professional_sports_team
/education/fraternity_sorority/colleges_and_universities	/education/fraternity_sorority	/education/university
/time/time_zone/locations_in_this_time_zone	/time/time_zone	/location/location
/film/film_featured_song/performed_by	/film/film_featured_song	/music/artist
/base/onephylogeny/type_of_thing/included_in	/base/onephylogeny/type_of_thing	/base/onephylogeny/type_of_thing
/royalty/noble_title/holders./royalty/noble_title_tenure/noble_person	/royalty/noble_title	/royalty/noble_person
/olympics/olympic_athlete/medals_won./olympics/olympic_medal_honor/medalist	/olympics/olympic_athlete	/olympics/olympic_athlete
/people/deceased_person/place_of_death	/people/deceased_person	/location/location
/award/award_nominee/award_nominations./award/award_nomination/nominated_for	/award/award_nominee	/award/award_nominated_work
/soccer/football_league/teams./soccer/football_league_participation/team	/soccer/football_league	/soccer/football_team
/base/popstra/celebrity/canoodled./base/popstra/canoodled/participant	/base/popstra/celebrity	/base/popstra/celebrity
/architecture/structure/owner./architecture/ownership/owner	/architecture/structure	/architecture/architectural_structure_owner
/base/infrastructure/power_plant_type/power_station	/base/infrastructure/power_plant_type	/base/infrastructure/power_station
/government/governmental_body/sessions	/government/governmental_body	/government/legislative_session
/music/group_member/instruments_played	/music/group_member	/music/instrument
/broadcast/broadcast/area_served	/broadcast/broadcast	/location/location
/film/film_distributor/films_distributed./film/film_film_distributor_relationship/film	/film/film_distributor	/film/film
/base/schemastaging/athlete_extra/salary./base/schemastaging/athlete_salary/currency	/base/schemastaging/athlete_extra	/finance/currency
/comic_books/comic_book_creator/characters_created	/comic_books/comic_book_creator	/comic_books/comic_book_character
/user/tsegaran/random/taxonomy_subject/entry./user/tsegaran/random/taxonomy_entry/taxonomy	/user/tsegaran/random/taxonomy_subject	/user/tsegaran/random/subject_taxonomy
/location/statistical_region/gdp_nominal_per_capita./measurement_unit/dated_money_value/currency	/location/statistical_region	/finance/currency
/american_football/football_player/passing./american_football/player_passing_statistics/season	/american_football/football_player	/sports/sports_league_season
/sports/sports_team/arena_stadium	/sports/sports_team	/sports/sports_facility
/organization/organization/place_founded	/organization/organization	/location/location
/base/bioventurist/science_or_technology_company/develops_treatments_for_disease	/base/bioventurist/science_or_technology_company	/base/bioventurist/bv_medical_condition
/base/popstra/company/shopping_choice./base/popstra/shopping_choice/shopper	/base/popstra/company	/base/popstra/celebrity
/government/political_district/representatives./government/government_position_held/governmental_body	/government/political_district	/government/governmental_body
/sports/sports_facility/teams	/sports/sports_facility	/sports/sports_team
/sports/multi_event_tournament/sports	/sports/multi_event_tournament	/sports/sport
/base/petbreeds/dog_breed/group	/base/petbreeds/dog_breed	/base/petbreeds/dog_breed_group
/base/eating/practicer_of_diet/diet	/base/eating/practicer_of_diet	/base/eating/diets
/people/person/employment_history./business/employment_tenure/company	/people/person	/business/employer
/book/written_work/subjects	/book/written_work	/book/book_subject
/film/film/edited_by	/film/film	/film/editor
/medicine/condition_prevention_factors/conditions_this_may_prevent	/medicine/condition_prevention_factors	/medicine/disease
/architecture/structure/construction_cost./measurement_unit/money_value/currency	/architecture/structure	/finance/currency
/architecture/architect/architectural_style	/architecture/architect	/architecture/architectural_style
/base/popstra/celebrity/bought./base/popstra/product_choice/product	/base/popstra/celebrity	/base/popstra/product
/education/educational_institution/school_type	/education/educational_institution	/education/school_category
/base/endorsements/endorsing_newspaper/endorsements./base/endorsements/newspaper_endorsement/endorsee	/base/endorsements/endorsing_newspaper	/base/endorsements/endorsee
/travel/transport_operator/travel_destinations_served./travel/transportation/transport_operator	/travel/transport_operator	/travel/transport_operator
/government/legislative_session/members./government/government_position_held/legislative_sessions	/government/legislative_session	/government/legislative_session
/location/hud_county_place/place	/location/hud_county_place	/location/location
/award/award_category/nominees./award/award_nomination/award_nominee	/award/award_category	/award/award_nominee
/film/film/film_set_decoration_by	/film/film	/film/film_set_designer
/education/academic/research_areas	/education/academic	/education/field_of_study
/user/ktrueman/default_domain/international_organization/member_states	/user/ktrueman/default_domain/international_organization	/location/country
/olympics/olympic_participating_country/medals_won./olympics/olympic_medal_honor/medalist	/olympics/olympic_participating_country	/olympics/olympic_athlete
/sports/sport/pro_athletes./sports/pro_sports_played/athlete	/sports/sport	/sports/pro_athlete
/soccer/football_team_manager/team./soccer/football_team_management_tenure/team	/soccer/football_team_manager	/soccer/football_team
/tv/tv_program/recurring_writers./tv/tv_program_writer_relationship/writer	/tv/tv_program	/tv/tv_writer
/religion/religious_organization/associated_with	/religion/religious_organization	/religion/religion
/film/film_character/portrayed_in_films_dubbed./film/dubbing_performance/film	/film/film_character	/film/film
/travel/travel_destination/how_to_get_here./travel/transportation/mode_of_transportation	/travel/travel_destination	/travel/transportation_mode
/olympics/olympic_games/medals_awarded./olympics/olympic_medal_honor/country	/olympics/olympic_games	/olympics/olympic_participating_country
/business/sponsored_recipient/sponsorship./business/sponsorship/sponsored_by	/business/sponsored_recipient	/business/sponsor
/organization/endowed_organization/endowment./measurement_unit/dated_money_value/currency	/organization/endowed_organization	/finance/currency
/book/written_work/author	/book/written_work	/book/author
/base/schemastaging/person_extra/net_worth./measurement_unit/dated_money_value/source	/base/schemastaging/person_extra	/dataworld/information_source
/aviation/airline/hubs	/aviation/airline	/aviation/airport
/exhibitions/exhibition_venue/exhibitions_at_this_venue./exhibitions/exhibition_run/sponsor	/exhibitions/exhibition_venue	/exhibitions/exhibition_sponsor
/location/statistical_region/places_imported_from./location/imports_and_exports/imported_from	/location/statistical_region	/location/statistical_region
/aviation/airport/serves	/aviation/airport	/location/location
/celebrities/sexual_orientation/celebrities./celebrities/sexual_orientation_phase/celebrity	/celebrities/sexual_orientation	/celebrities/celebrity
/soccer/football_team/manager./soccer/football_team_management_tenure/manager	/soccer/football_team	/soccer/football_team_manager
/sports/sports_award_winner/awards./sports/sports_award/team	/sports/sports_award_winner	/sports/sports_team
/media_common/netflix_genre/titles	/media_common/netflix_genre	/media_common/netflix_title
/base/schemastaging/tv_actor_extra/regular_dubbing_performances./base/schemastaging/tv_star_dubbing_performance/program	/base/schemastaging/tv_actor_extra	/base/schemastaging/tv_program_extra
/military/military_conflict/force_strengths./military/force_strength/combatant	/military/military_conflict	/military/military_combatant
/religion/religion/texts	/religion/religion	/religion/religious_text
/people/person/children	/people/person	/people/person
/base/activism/activist/area_of_activism	/base/activism/activist	/base/activism/activism_issue
/royalty/monarch/royal_line	/royalty/monarch	/royalty/royal_line
/tv/tv_series_episode/series	/tv/tv_series_episode	/tv/tv_program
/broadcast/genre/content	/broadcast/genre	/broadcast/content
/organization/organization/product_of_merger./organization/organization_merger/organizations_merging	/organization/organization	/organization/organization
/theater/play/genre	/theater/play	/theater/theater_genre
/american_football/football_coach/coaching_history./american_football/football_historical_coach_position/position	/american_football/football_coach	/american_football/football_coach_position
/computer/software_developer/software	/computer/software_developer	/computer/software
/sports/sports_position/players./sports/sports_team_roster/team	/sports/sports_position	/sports/sports_team
/education/school_mascot/school	/education/school_mascot	/education/educational_institution
/royalty/royal_line/kingdom_s_ruled	/royalty/royal_line	/royalty/kingdom
/business/business_operation/revenue./measurement_unit/dated_money_value/currency	/business/business_operation	/finance/currency
/base/thoroughbredracing/thoroughbred_racehorse/color	/base/thoroughbredracing/thoroughbred_racehorse	/base/thoroughbredracing/thoroughbred_racehorse_color
/sports/sports_league_season/awards./sports/sports_award/award_winner	/sports/sports_league_season	/sports/sports_award_winner
/architecture/architectural_style/architects	/architecture/architectural_style	/architecture/architect
/computer/operating_system/developer	/computer/operating_system	/computer/operating_system_developer
/government/legislative_session/members./government/government_position_held/office_position_or_title	/government/legislative_session	/government/government_office_or_title
/cvg/computer_videogame/sequel	/cvg/computer_videogame	/cvg/computer_videogame
/olympics/olympic_games/medals_awarded./olympics/olympic_medal_honor/medalist	/olympics/olympic_games	/olympics/olympic_athlete
/base/wrestling/professional_wrestler/member_of_team	/base/wrestling/professional_wrestler	/base/wrestling/solo_wrestler_or_team
/finance/currency/countries_formerly_used	/finance/currency	/location/country
/base/schemastaging/tv_character_extra/regular_dubbing_performances./base/schemastaging/tv_star_dubbing_performance/actor	/base/schemastaging/tv_character_extra	/base/schemastaging/tv_actor_extra
/geography/geographical_feature/category	/geography/geographical_feature	/geography/geographical_feature_category
/award/award_presenting_organization/award_categories_presented	/award/award_presenting_organization	/award/award_category
/computer/operating_system/includes_os_versions	/computer/operating_system	/computer/operating_system
/sports/sport/related_equipment	/sports/sport	/sports/sports_equipment
/tv/tv_producer/tv_episodes_produced./tv/tv_producer_episode_credit/episode	/tv/tv_producer	/tv/tv_series_episode
/people/person/spouse_s./people/marriage/type_of_union	/people/person	/people/marriage_union_type
/food/dish/ingredients	/food/dish	/food/ingredient
/film/film/film_production_design_by	/film/film	/film/film_production_designer
/military/military_post/used_by_armed_forces./military/military_post_use/armed_force	/military/military_post	/military/armed_force
/user/tsegaran/computer/algorithm_family/algorithm	/user/tsegaran/computer/algorithm_family	/user/tsegaran/computer/algorithm
/base/popstra/celebrity/supporter./base/popstra/support/supported_organization	/base/popstra/celebrity	/base/popstra/organization
/sports/sports_league_season/awards./sports/sports_award/award	/sports/sports_league_season	/sports/sports_award_type
/language/language_writing_system/languages	/language/language_writing_system	/language/human_language
/base/schemastaging/organization_extra/phone_number./base/schemastaging/phone_sandbox/contact_category	/base/schemastaging/organization_extra	/organization/contact_category
/film/film_festival_event/festival	/film/film_festival_event	/film/film_festival
/cvg/cvg_designer/games_designed	/cvg/cvg_designer	/cvg/computer_videogame
/government/governmental_jurisdiction/government_bodies	/government/governmental_jurisdiction	/government/governmental_body
/base/folklore/mythical_creature/mythology	/base/folklore/mythical_creature	/base/folklore/mythology
/tv/non_character_role/tv_guest_personal_appearances./tv/tv_guest_personal_appearance/person	/tv/non_character_role	/tv/tv_program_guest
/location/location/events	/location/location	/time/event
/education/educational_institution/colors	/education/educational_institution	/visual_art/color
/law/inventor/inventions	/law/inventor	/law/invention
/base/schemastaging/tv_program_extra/regular_dubbing_performances./base/schemastaging/tv_star_dubbing_performance/actor	/base/schemastaging/tv_program_extra	/base/schemastaging/tv_actor_extra
/film/film_festival/location	/film/film_festival	/location/location
/theater/play/lyricist	/theater/play	/theater/theatrical_lyricist
/people/person/education./education/education/degree	/people/person	/education/educational_degree
/astronomy/star_system_body/star_system	/astronomy/star_system_body	/astronomy/star_system
/base/x2010fifaworldcupsouthafrica/world_cup_squad/current_world_cup_squad./base/x2010fifaworldcupsouthafrica/current_world_cup_squad/players	/base/x2010fifaworldcupsouthafrica/world_cup_squad	/base/x2010fifaworldcupsouthafrica/world_cup_participant
/base/fight/sentence/convictions./base/crime/criminal_conviction/convicted_person	/base/fight/sentence	/base/crime/convicted_criminal
/base/americancomedy/comedy_group/members./base/americancomedy/comedy_group_membership/member	/base/americancomedy/comedy_group	/base/americancomedy/comedy_group_member
/protected_sites/governing_body_of_protected_sites/protected_sites_governed	/protected_sites/governing_body_of_protected_sites	/protected_sites/protected_site
/business/job_title/people_with_this_title./business/employment_tenure/company	/business/job_title	/business/employer
/tv/tv_series_episode/writer	/tv/tv_series_episode	/tv/tv_writer
/government/legislative_session/members./government/government_position_held/jurisdiction_of_office	/government/legislative_session	/government/governmental_jurisdiction
/business/job_title/people_with_this_title./business/employment_tenure/person	/business/job_title	/people/person
/base/localfood/produce/availability./base/localfood/produce_availability/seasonal_months	/base/localfood/produce	/base/localfood/seasonal_month
/film/film_character/portrayed_in_films./film/performance/film	/film/film_character	/film/film
/base/schemastaging/tv_character_extra/regular_dubbing_performances./base/schemastaging/tv_star_dubbing_performance/language	/base/schemastaging/tv_character_extra	/language/human_language
/sports/sports_award_type/winners./sports/sports_award/award_winner	/sports/sports_award_type	/sports/sports_award_winner
/broadcast/radio_station/format	/broadcast/radio_station	/broadcast/radio_format
/common/topic/webpage./common/webpage/category	/common/topic	/common/annotation_category
/sports/sport/teams	/sports/sport	/sports/sports_team
/sports/sports_team_location/teams	/sports/sports_team_location	/sports/sports_team
/basketball/basketball_position/player_roster_position./sports/sports_team_roster/team	/basketball/basketball_position	/sports/sports_team
/people/person/languages	/people/person	/language/human_language
/base/popstra/company/product_endorser./base/popstra/paid_support/endorser	/base/popstra/company	/base/popstra/celebrity
/basketball/basketball_team/roster./sports/sports_team_roster/player	/basketball/basketball_team	/sports/pro_athlete
/broadcast/content/location	/broadcast/content	/location/location
/book/written_work/original_language	/book/written_work	/language/human_language
/time/event/instance_of_recurring_event	/time/event	/time/recurring_event
/sports/sports_team/roster./sports/sports_team_roster/player	/sports/sports_team	/sports/pro_athlete
/music/instrument/variation	/music/instrument	/music/instrument
/sports/drafted_athlete/drafted./sports/sports_league_draft_pick/team	/sports/drafted_athlete	/sports/professional_sports_team
/film/film_costumer_designer/costume_design_for_film	/film/film_costumer_designer	/film/film
/ice_hockey/hockey_player/hockey_position	/ice_hockey/hockey_player	/ice_hockey/hockey_position
/olympics/olympic_athlete/country./olympics/olympic_athlete_affiliation/sport	/olympics/olympic_athlete	/olympics/olympic_sport
/geography/river/cities	/geography/river	/location/citytown
/military/armed_force/military_posts./military/military_post_use/military_post	/military/armed_force	/military/military_post
/film/film/film_series	/film/film	/film/film_series
/medicine/medical_specialty/diseases_treated	/medicine/medical_specialty	/medicine/disease
/film/film_job/films_with_this_crew_job./film/film_crew_gig/film	/film/film_job	/film/film
/base/contractbridge/bridge_player/first_place_finish./base/contractbridge/bridge_tournament_standings/first_place	/base/contractbridge/bridge_player	/base/contractbridge/bridge_player
/sports/sports_official/sport	/sports/sports_official	/sports/sport
/film/film/country	/film/film	/location/country
/american_football/football_team/current_roster./sports/sports_team_roster/position	/american_football/football_team	/sports/sports_position
/book/periodical_subject/periodicals	/book/periodical_subject	/book/periodical
/film/film/starring./film/performance/actor	/film/film	/film/actor
/award/hall_of_fame/discipline	/award/hall_of_fame	/award/hall_of_fame_discipline
/government/government_office_or_title/office_holders./government/government_position_held/office_holder	/government/government_office_or_title	/government/politician
/computer/computer_manufacturer_brand/computer_models	/computer/computer_manufacturer_brand	/computer/computer
/government/governmental_jurisdiction/agencies	/government/governmental_jurisdiction	/government/government_agency
/travel/transport_terminus/travel_destinations_served./travel/transportation/travel_destination	/travel/transport_terminus	/travel/travel_destination
/common/resource/annotations./common/webpage/topic	/common/resource	/common/topic
/base/crime/crime/victim_s	/base/crime/crime	/base/crime/crime_victim
/base/bioventurist/bv_medical_condition/company_involved	/base/bioventurist/bv_medical_condition	/base/bioventurist/science_or_technology_company
/base/marchmadness/ncaa_basketball_team/ncaa_tournament_seeds./base/marchmadness/ncaa_tournament_seed/tournament	/base/marchmadness/ncaa_basketball_team	/base/marchmadness/ncaa_basketball_tournament
/common/topic/webpage./common/webpage/resource	/common/topic	/common/resource
/music/album/genre	/music/album	/music/genre
/sports/sports_championship/events	/sports/sports_championship	/sports/sports_championship_event
/tv/tv_program/languages	/tv/tv_program	/language/human_language
/dataworld/gardening_hint/split_to	/dataworld/gardening_hint	/type/object
/internet/website/owner_new./internet/website_ownership/owner	/internet/website	/internet/website_owner
/religion/religion/includes	/religion/religion	/religion/religion
/government/legislative_session/legislature	/government/legislative_session	/government/governmental_body
/transportation/bridge_type/bridges_of_this_type	/transportation/bridge_type	/transportation/bridge
/american_football/football_team/historical_coaching_staff./american_football/football_historical_coach_position/coach	/american_football/football_team	/american_football/football_coach
/baseball/baseball_player/lifetime_batting_statistics./baseball/lifetime_batting_statistics/last_statistics_season	/baseball/baseball_player	/sports/sports_league_season
/tv/tv_program/regular_personal_appearances./tv/tv_regular_personal_appearance/person	/tv/tv_program	/tv/tv_personality
/music/musical_group/member./music/group_membership/member	/music/musical_group	/music/group_member
/tv/tv_program/filming_locations	/tv/tv_program	/tv/tv_location
/user/mt/default_domain/metabolite/associated_disorder	/user/mt/default_domain/metabolite	/medicine/disease
/award/long_list_nominee/long_list_nominations./award/long_list_nomination/award	/award/long_list_nominee	/award/award_category
/medicine/disease/symptoms	/medicine/disease	/medicine/symptom
/language/human_language/main_country	/language/human_language	/location/country
/tv/tv_network/programs./tv/tv_network_duration/program	/tv/tv_network	/tv/tv_program
/base/crime/convicted_criminal/convictions./base/crime/criminal_conviction/sentence_type	/base/crime/convicted_criminal	/base/fight/sentence
/fictional_universe/work_of_fiction/setting	/fictional_universe/work_of_fiction	/fictional_universe/fictional_setting
/computer/operating_system/parent_os	/computer/operating_system	/computer/operating_system
/fictional_universe/fictional_character/based_on	/fictional_universe/fictional_character	/fictional_universe/person_in_fiction
/olympics/olympic_games/participating_countries	/olympics/olympic_games	/olympics/olympic_participating_country
/book/magazine/genre	/book/magazine	/book/magazine_genre
/base/popstra/location/vacationers./base/popstra/vacation_choice/vacationer	/base/popstra/location	/base/popstra/celebrity
/military/military_combatant/military_commanders./military/military_command/military_commander	/military/military_combatant	/military/military_commander
/government/politician/government_positions_held./government/government_position_held/office_position_or_title	/government/politician	/government/government_office_or_title
/medicine/disease/notable_people_with_this_condition	/medicine/disease	/medicine/notable_person_with_medical_condition
/education/educational_degree/people_with_this_degree./education/education/major_field_of_study	/education/educational_degree	/education/field_of_study
/sports/pro_athlete/teams./sports/sports_team_roster/team	/sports/pro_athlete	/sports/sports_team
/base/collectives/collective_member/member_of./base/collectives/collective_membership/collective	/base/collectives/collective_member	/base/collectives/collective
/aviation/airport/airlines./aviation/airline_airport_presence/airline	/aviation/airport	/aviation/airline
/soccer/football_player/matches_played./soccer/football_player_match_participation/team	/soccer/football_player	/soccer/football_team
/film/actor/dubbing_performances./film/dubbing_performance/film	/film/actor	/film/film
/tv/tv_program/country_of_origin	/tv/tv_program	/location/country
/education/field_of_study/students_majoring./education/education/student	/education/field_of_study	/people/person
/film/actor/film./film/performance/special_performance_type	/film/actor	/film/special_film_performance_type
/location/administrative_division/capital./location/administrative_division_capital_relationship/capital	/location/administrative_division	/location/capital_of_administrative_division
/biology/breed_registry/recognized_breeds./biology/breed_registration/breed	/biology/breed_registry	/biology/animal_breed
/music/record_label/artist	/music/record_label	/music/artist
/media_common/adapted_work/adaptations	/media_common/adapted_work	/media_common/adaptation
/user/tfmorris/default_domain/document/signatories	/user/tfmorris/default_domain/document	/user/tfmorris/default_domain/signatory
/comic_books/comic_book_publisher/comic_book_series_published	/comic_books/comic_book_publisher	/comic_books/comic_book_series
/medicine/disease_cause/diseases	/medicine/disease_cause	/medicine/disease
/government/governmental_body/jurisdiction	/government/governmental_body	/government/governmental_jurisdiction
/user/tsegaran/computer/algorithm/family	/user/tsegaran/computer/algorithm	/user/tsegaran/computer/algorithm_family
/film/film/dubbing_performances./film/dubbing_performance/character	/film/film	/film/film_character
/education/field_of_study/students_majoring./education/education/institution	/education/field_of_study	/education/educational_institution
/government/political_appointer/appointees./government/government_position_held/basic_title	/government/political_appointer	/government/government_office_category
/religion/religious_organization/leaders./religion/religious_organization_leadership/leader	/religion/religious_organization	/religion/religious_leader
/base/popstra/product/sold_to./base/popstra/product_choice/consumer	/base/popstra/product	/base/popstra/celebrity
/military/military_commander/military_commands./military/military_command/military_combatant	/military/military_commander	/military/military_combatant
/fictional_universe/ethnicity_in_fiction/characters_of_this_ethnicity	/fictional_universe/ethnicity_in_fiction	/fictional_universe/fictional_character
/food/ingredient/incompatible_with_dietary_restrictions	/food/ingredient	/food/dietary_restriction
/government/governmental_body/component_bodies	/government/governmental_body	/government/governmental_body
/protected_sites/listed_site/designation_as_natural_or_cultural_site./protected_sites/natural_or_cultural_site_listing/category_or_criteria	/protected_sites/listed_site	/protected_sites/site_listing_category
/metropolitan_transit/transit_system/area_served	/metropolitan_transit/transit_system	/location/location
/architecture/structure/architect	/architecture/structure	/architecture/architect
/organization/membership_organization/members./organization/organization_membership/member	/organization/membership_organization	/organization/organization_member
/metropolitan_transit/transit_service_type/transit_lines	/metropolitan_transit/transit_service_type	/metropolitan_transit/transit_line
/computer/operating_system_developer/operating_systems_developed	/computer/operating_system_developer	/computer/operating_system
/theater/theatrical_lyricist/play_lyrics_written	/theater/theatrical_lyricist	/theater/play
/education/educational_degree/people_with_this_degree./education/education/specialization	/education/educational_degree	/education/field_of_study
/location/hud_foreclosure_area/total_residential_addresses./measurement_unit/dated_integer/source	/location/hud_foreclosure_area	/dataworld/information_source
/education/fraternity_sorority/colors	/education/fraternity_sorority	/visual_art/color
/base/fashionmodels/hair_color/fashion_models_with_this_hair_color	/base/fashionmodels/hair_color	/base/fashionmodels/fashion_model
/language/human_language/language_family	/language/human_language	/language/language_family
/protected_sites/protected_site/iucn_category	/protected_sites/protected_site	/protected_sites/iucn_category
/organization/organization/headquarters./location/mailing_address/state_province_region	/organization/organization	/location/administrative_division
/film/film_casting_director/films_casting_directed	/film/film_casting_director	/film/film
/government/governmental_body/members./government/government_position_held/basic_title	/government/governmental_body	/government/government_office_category
/astronomy/celestial_object_category/objects	/astronomy/celestial_object_category	/astronomy/celestial_object
/organization/organization/child./organization/organization_relationship/child	/organization/organization	/organization/organization
/american_football/football_player/rushing./american_football/player_rushing_statistics/team	/american_football/football_player	/american_football/football_team
/film/film/genre	/film/film	/film/film_genre
/olympics/olympic_participating_country/athletes./olympics/olympic_athlete_affiliation/olympics	/olympics/olympic_participating_country	/olympics/olympic_games
/comic_books/comic_book_creator/series_created	/comic_books/comic_book_creator	/comic_books/comic_book_series
/business/consumer_company/brands./business/company_brand_relationship/brand	/business/consumer_company	/business/brand
/biology/breed_origin/breeds_originating_here	/biology/breed_origin	/biology/animal_breed
/aviation/airport/airlines./aviation/airline_airport_presence/cities_served	/aviation/airport	/location/citytown
/law/invention/inventor	/law/invention	/law/inventor
/broadcast/content/broadcast	/broadcast/content	/broadcast/broadcast
/award/award_category/winners./award/award_honor/award_winner	/award/award_category	/award/award_winner
/medicine/notable_person_with_medical_condition/condition	/medicine/notable_person_with_medical_condition	/medicine/disease
/biology/organism_classification/lower_classifications	/biology/organism_classification	/biology/organism_classification
/media_common/netflix_title/netflix_genres	/media_common/netflix_title	/media_common/netflix_genre
/law/court/judges./law/judicial_tenure/judge	/law/court	/law/judge
/olympics/olympic_games/sports	/olympics/olympic_games	/olympics/olympic_sport
/base/petbreeds/dog_breed/cities_where_this_dog_is_popular./base/petbreeds/dog_city_relationship/cities	/base/petbreeds/dog_breed	/base/petbreeds/city_with_dogs
/organization/organization_founder/organizations_founded	/organization/organization_founder	/organization/organization
/film/film_festival_event/films	/film/film_festival_event	/film/film
/celebrities/celebrity/sexual_orientation./celebrities/sexual_orientation_phase/sexual_orientation	/celebrities/celebrity	/celebrities/sexual_orientation
/base/culturalevent/event/entity_involved	/base/culturalevent/event	/common/topic
/sports/sports_team/league./sports/sports_league_participation/league	/sports/sports_team	/sports/sports_league
/broadcast/broadcast/distributor	/broadcast/broadcast	/broadcast/distributor
/music/performance_role/guest_performances./music/recording_contribution/performance_role	/music/performance_role	/music/performance_role
/sports/sports_championship_event/champion	/sports/sports_championship_event	/sports/sports_team
/tv/tv_program/tv_producer./tv/tv_producer_term/producer_type	/tv/tv_program	/tv/tv_producer_type
/tennis/tennis_tournament_champion/tennis_titles./tennis/tennis_tournament_championship/winner	/tennis/tennis_tournament_champion	/tennis/tennis_tournament_champion
/film/film/costume_design_by	/film/film	/film/film_costumer_designer
/computer/programming_language_paradigm/languages	/computer/programming_language_paradigm	/computer/programming_language
/user/tsegaran/random/subject_taxonomy/entry./user/tsegaran/random/taxonomy_entry/subject	/user/tsegaran/random/subject_taxonomy	/user/tsegaran/random/taxonomy_subject
/organization/organization/spin_offs./organization/organization_spin_off/child_company	/organization/organization	/organization/organization
/book/periodical/publisher./book/periodical_publisher_period/publisher	/book/periodical	/book/periodical_publisher
/award/award_winner/awards_won./award/award_honor/award	/award/award_winner	/award/award_category
/award/hall_of_fame_inductee/hall_of_fame_inductions./award/hall_of_fame_induction/hall_of_fame	/award/hall_of_fame_inductee	/award/hall_of_fame
/cvg/game_character/games./cvg/game_performance/voice_actor	/cvg/game_character	/cvg/game_voice_actor
/base/eating/diets/people_who_follow_this_diet	/base/eating/diets	/base/eating/practicer_of_diet
/soccer/football_team/current_roster./sports/sports_team_roster/player	/soccer/football_team	/sports/pro_athlete
/sports/sports_league_draft/picks./sports/sports_league_draft_pick/player	/sports/sports_league_draft	/sports/drafted_athlete
/soccer/football_team/league./soccer/football_league_participation/league	/soccer/football_team	/soccer/football_league
/olympics/olympic_athlete/country./olympics/olympic_athlete_affiliation/country	/olympics/olympic_athlete	/olympics/olympic_participating_country
/baseball/baseball_player/batting_stats./baseball/batting_statistics/team	/baseball/baseball_player	/baseball/baseball_team
/organization/organization/sectors	/organization/organization	/organization/organization_sector
/sports/sports_team/roster./sports/sports_team_roster/position	/sports/sports_team	/sports/sports_position
/sports/sports_award_type/winners./sports/sports_award/season	/sports/sports_award_type	/sports/sports_league_season
/education/field_of_study/students_majoring./education/education/degree	/education/field_of_study	/education/educational_degree
/base/schemastaging/organization_extra/phone_number./base/schemastaging/phone_open_times/time_zone	/base/schemastaging/organization_extra	/time/time_zone
/people/person/ethnicity	/people/person	/people/ethnicity
/film/film_series/films_in_series	/film/film_series	/film/film
/astronomy/orbital_relationship/orbited_by	/astronomy/orbital_relationship	/astronomy/orbital_relationship
/government/legislative_session/members./government/government_position_held/governmental_body	/government/legislative_session	/government/governmental_body
/education/field_of_study/subdisciplines	/education/field_of_study	/education/field_of_study
/biology/organism/organism_type	/biology/organism	/biology/organism_classification
/government/government_office_category/officeholders./government/government_position_held/jurisdiction_of_office	/government/government_office_category	/government/governmental_jurisdiction
/award/hall_of_fame_discipline/halls_of_fame	/award/hall_of_fame_discipline	/award/hall_of_fame
/olympics/olympic_games/athletes./olympics/olympic_athlete_affiliation/athlete	/olympics/olympic_games	/olympics/olympic_athlete
/business/business_operation/current_liabilities./measurement_unit/dated_money_value/currency	/business/business_operation	/finance/currency
/film/film/estimated_budget./measurement_unit/dated_money_value/currency	/film/film	/finance/currency
/business/sponsor/sponsorship./business/sponsorship/sponsored_recipient	/business/sponsor	/business/sponsored_recipient
/media_common/media_genre/parent_genre	/media_common/media_genre	/media_common/media_genre
/olympics/olympic_sport/athletes./olympics/olympic_athlete_affiliation/athlete	/olympics/olympic_sport	/olympics/olympic_athlete
/medicine/icd_9_cm_classification/includes_classifications	/medicine/icd_9_cm_classification	/medicine/icd_9_cm_classification
/american_football/football_player/passing./american_football/player_passing_statistics/team	/american_football/football_player	/american_football/football_team
/government/government_office_category/officeholders./government/government_position_held/office_holder	/government/government_office_category	/government/politician
/location/country/capital	/location/country	/location/citytown
/location/location/adjoin_s./location/adjoining_relationship/adjoins	/location/location	/location/location
/medicine/infectious_disease/infectious_agent_type	/medicine/infectious_disease	/medicine/type_of_infectious_agent
/user/alexbl/honorary_title/honorary_title/titled_people./user/alexbl/honorary_title/honorary_title_holding/conferred_upon	/user/alexbl/honorary_title/honorary_title	/user/alexbl/honorary_title/titled_person
/common/topic/subject_of	/common/topic	/common/topic
/american_football/football_player/position_s	/american_football/football_player	/sports/sports_position
/government/government_office_category/officeholders./government/government_position_held/appointed_by	/government/government_office_category	/government/political_appointer
/royalty/kingdom/rulers	/royalty/kingdom	/royalty/monarch
/biology/organism/sex	/biology/organism	/people/gender
/broadcast/distributor/distributes	/broadcast/distributor	/broadcast/broadcast
/government/government_office_or_title/office_holders./government/government_position_held/governmental_body	/government/government_office_or_title	/government/governmental_body
/media_common/dedicatee/dedications./media_common/dedication/work_dedicated	/media_common/dedicatee	/media_common/dedicated_work
/base/localfood/seasonal_month/produce_available./base/localfood/produce_availability/produce	/base/localfood/seasonal_month	/base/localfood/produce
/film/film/produced_by	/film/film	/film/producer
/book/author/school_or_movement	/book/author	/book/school_or_movement
/music/artist/origin	/music/artist	/location/location
/sports/professional_sports_team/draft_picks./sports/sports_league_draft_pick/school	/sports/professional_sports_team	/education/educational_institution
/tv/tv_character/appeared_in_tv_program./tv/regular_tv_appearance/actor	/tv/tv_character	/tv/tv_actor
/sports/sports_team/championships	/sports/sports_team	/sports/sports_championship_event
/common/topic/subjects	/common/topic	/common/topic
/government/government_office_category/officeholders./government/government_position_held/governmental_body	/government/government_office_category	/government/governmental_body
/government/political_appointer/appointees./government/government_position_held/jurisdiction_of_office	/government/political_appointer	/government/governmental_jurisdiction
/organization/role/governors./organization/organization_board_membership/member	/organization/role	/business/board_member
/people/marriage_union_type/unions_of_this_type./people/marriage/location_of_ceremony	/people/marriage_union_type	/location/location
/tv/special_tv_performance_type/starring_performances./tv/regular_tv_appearance/series	/tv/special_tv_performance_type	/tv/tv_program
/film/film/language	/film/film	/language/human_language
/medicine/symptom/symptom_of	/medicine/symptom	/medicine/disease
/location/location/street_address./location/mailing_address/citytown	/location/location	/location/location
/ice_hockey/hockey_team/historical_roster./sports/sports_team_roster/player	/ice_hockey/hockey_team	/sports/pro_athlete
/fictional_universe/character_occupation/characters_with_this_occupation	/fictional_universe/character_occupation	/fictional_universe/fictional_character
/travel/transport_operator/travel_destinations_served./travel/transportation/mode_of_transportation	/travel/transport_operator	/travel/transportation_mode
/fictional_universe/work_of_fiction/part_of_these_fictional_universes	/fictional_universe/work_of_fiction	/fictional_universe/fictional_universe
/government/government_office_category/offices	/government/government_office_category	/government/government_office_or_title
/base/schemastaging/person_extra/net_worth./measurement_unit/dated_money_value/currency	/base/schemastaging/person_extra	/finance/currency
/base/marchmadness/ncaa_basketball_tournament/seeds./base/marchmadness/ncaa_tournament_seed/team	/base/marchmadness/ncaa_basketball_tournament	/base/marchmadness/ncaa_basketball_team
/location/administrative_division/second_level_division_of	/location/administrative_division	/location/country
/fictional_universe/fictional_setting/works_set_here	/fictional_universe/fictional_setting	/fictional_universe/work_of_fiction
/tv/tv_personality/tv_regular_appearances./tv/tv_regular_personal_appearance/program	/tv/tv_personality	/tv/tv_program
/tv/tv_actor/guest_roles./tv/tv_guest_role/episodes_appeared_in	/tv/tv_actor	/tv/tv_series_episode
/visual_art/artwork/art_genre	/visual_art/artwork	/visual_art/visual_art_genre
/location/statistical_region/places_exported_to./location/imports_and_exports/exported_to	/location/statistical_region	/location/statistical_region
/film/film/film_festivals	/film/film	/film/film_festival_event
/computer/programming_language/parent_language	/computer/programming_language	/computer/programming_language
/computer/computer/compatible_oses./computer/os_compatibility/operating_system	/computer/computer	/computer/operating_system
/fictional_universe/fictional_character/powers_or_abilities	/fictional_universe/fictional_character	/fictional_universe/character_powers
/award/award/category	/award/award	/award/award_category
/sports/sports_championship_event/runner_up	/sports/sports_championship_event	/sports/sports_team
/location/statistical_region/gdp_nominal./measurement_unit/dated_money_value/currency	/location/statistical_region	/finance/currency
/travel/travel_destination/tourist_attractions	/travel/travel_destination	/travel/tourist_attraction
/travel/transport_terminus/travel_destinations_served./travel/transportation/mode_of_transportation	/travel/transport_terminus	/travel/transportation_mode
/film/film_character/portrayed_in_films./film/performance/actor	/film/film_character	/film/actor
/education/academic/appointments_fellowships_etc./education/academic_post/institution	/education/academic	/education/academic_institution
/location/us_county/county_seat	/location/us_county	/location/citytown
/government/government_office_or_title/office_holders./government/government_position_held/legislative_sessions	/government/government_office_or_title	/government/legislative_session
/government/government_office_or_title/jurisdiction	/government/government_office_or_title	/government/governmental_jurisdiction
/award/award_ceremony/awards_presented./award/award_honor/honored_for	/award/award_ceremony	/award/award_winning_work
/award/award_nominated_work/award_nominations./award/award_nomination/nominated_for	/award/award_nominated_work	/award/award_nominated_work
/film/film/runtime./film/film_cut/film_release_region	/film/film	/location/location
/film/director/film	/film/director	/film/film
/basketball/basketball_position/players	/basketball/basketball_position	/basketball/basketball_player
/base/popstra/celebrity/dated./base/popstra/dated/participant	/base/popstra/celebrity	/base/popstra/celebrity
/soccer/football_player/position_s	/soccer/football_player	/soccer/football_position
/tv/tv_character/appeared_in_tv_program./tv/regular_tv_appearance/series	/tv/tv_character	/tv/tv_program
/location/hud_foreclosure_area/total_90_day_vacant_residential_addresses./measurement_unit/dated_integer/source	/location/hud_foreclosure_area	/dataworld/information_source
/user/szaijan/fantasy_football/player/position	/user/szaijan/fantasy_football/player	/user/szaijan/fantasy_football/position
/government/form_of_government/countries	/government/form_of_government	/location/country
/business/board_member/organization_board_memberships./organization/organization_board_membership/role	/business/board_member	/organization/role
/tv/tv_program/episodes	/tv/tv_program	/tv/tv_series_episode
/location/administrative_division/first_level_division_of	/location/administrative_division	/location/country
/organization/organization/organization_type	/organization/organization	/organization/organization_type
/base/x2010fifaworldcupsouthafrica/world_cup_squad/current_world_cup_squad./base/x2010fifaworldcupsouthafrica/current_world_cup_squad/current_club	/base/x2010fifaworldcupsouthafrica/world_cup_squad	/soccer/football_team
/aviation/airport/focus_city_for	/aviation/airport	/aviation/airline
/government/government_office_or_title/office_holders./government/government_position_held/jurisdiction_of_office	/government/government_office_or_title	/government/governmental_jurisdiction
/base/academyawards/host_of_oscar_show/oscar_show_hosted	/base/academyawards/host_of_oscar_show	/time/event
/base/popstra/celebrity/endorsements./base/popstra/paid_support/company	/base/popstra/celebrity	/base/popstra/company
/business/business_operation/net_profit./measurement_unit/dated_money_value/currency	/business/business_operation	/finance/currency
/film/film/film_format	/film/film	/film/film_format
/government/governmental_jurisdiction/governing_officials./government/government_position_held/governmental_body	/government/governmental_jurisdiction	/government/governmental_body
/film/film/featured_film_locations	/film/film	/film/film_location
/geography/geographical_feature_category/features	/geography/geographical_feature_category	/geography/geographical_feature
/book/book/genre	/book/book	/media_common/literary_genre
/government/governmental_body/members./government/government_position_held/jurisdiction_of_office	/government/governmental_body	/government/governmental_jurisdiction
/organization/organization_scope/organizations_with_this_scope	/organization/organization_scope	/organization/organization
/book/periodical_format/periodicals_in_this_format./book/periodical_format_period/periodical	/book/periodical_format	/book/periodical
/computer/software/compatible_oses./computer/software_compatibility/operating_system	/computer/software	/computer/operating_system
/base/argumentmaps/innovator/original_ideas	/base/argumentmaps/innovator	/base/argumentmaps/original_idea
/travel/travel_destination/climate./travel/travel_destination_monthly_climate/month	/travel/travel_destination	/time/month
/venture_capital/venture_investor/investments./venture_capital/venture_investment/company	/venture_capital/venture_investor	/venture_capital/venture_funded_company
/tv/tv_series_season/regular_cast./tv/regular_tv_appearance/actor	/tv/tv_series_season	/tv/tv_actor
/music/genre/subgenre	/music/genre	/music/genre
/tv/tv_producer/programs_produced./tv/tv_producer_term/producer_type	/tv/tv_producer	/tv/tv_producer_type
/architecture/architectural_structure_owner/structures_owned./architecture/ownership/structure	/architecture/architectural_structure_owner	/architecture/structure
/organization/organization/legal_structure	/organization/organization	/business/company_type
/influence/influence_node/influenced_by	/influence/influence_node	/influence/influence_node
/time/event/included_in_event	/time/event	/time/event
/sports/drafted_athlete/drafted./sports/sports_league_draft_pick/draft	/sports/drafted_athlete	/sports/sports_league_draft
/location/hud_county_place/county	/location/hud_county_place	/location/us_county
/cvg/computer_videogame/gameplay_modes	/cvg/computer_videogame	/cvg/gameplay_mode
/award/award_category/winners./award/award_honor/honored_for	/award/award_category	/award/award_winning_work
/dining/cuisine/ingredients	/dining/cuisine	/food/ingredient
/government/governmental_jurisdiction/governing_officials./government/government_position_held/district_represented	/government/governmental_jurisdiction	/government/political_district
/award/hall_of_fame_inductee/hall_of_fame_inductions./award/hall_of_fame_induction/category	/award/hall_of_fame_inductee	/award/hall_of_fame_induction_category
/computer/programming_language/influenced	/computer/programming_language	/computer/programming_language
/tv/tv_character/appeared_in_tv_episodes./tv/tv_guest_role/actor	/tv/tv_character	/tv/tv_actor
/education/school_district/locations_served	/education/school_district	/location/location
/exhibitions/exhibition_sponsor/exhibitions_sponsored./exhibitions/exhibition_run/sponsor	/exhibitions/exhibition_sponsor	/exhibitions/exhibition_sponsor
/people/family/members	/people/family	/people/family_member
/broadcast/content/artist	/broadcast/content	/broadcast/artist
/organization/organization/leadership./organization/leadership/person	/organization/organization	/business/board_member
/music/concert_tour/artist	/music/concert_tour	/music/artist
/transportation/road/major_cities	/transportation/road	/location/citytown
/base/petbreeds/city_with_dogs/top_breeds./base/petbreeds/dog_city_relationship/dog_breed	/base/petbreeds/city_with_dogs	/base/petbreeds/dog_breed
/ice_hockey/hockey_team/current_roster./sports/sports_team_roster/player	/ice_hockey/hockey_team	/sports/pro_athlete
/government/political_ideology/political_parties	/government/political_ideology	/government/political_party
/user/robert/us_congress/congressional_caucus/current_house_members	/user/robert/us_congress/congressional_caucus	/user/robert/us_congress/us_representative
/government/governmental_jurisdiction/governing_officials./government/government_position_held/legislative_sessions	/government/governmental_jurisdiction	/government/legislative_session
/government/government_office_category/officeholders./government/government_position_held/district_represented	/government/government_office_category	/government/political_district
/exhibitions/exhibition_sponsor/exhibitions_sponsored./exhibitions/exhibition_run/venue	/exhibitions/exhibition_sponsor	/exhibitions/exhibition_venue
/media_common/adaptation/adapted_from	/media_common/adaptation	/media_common/adapted_work
/base/crime/convicted_criminal/convictions./base/crime/criminal_conviction/guilty_of	/base/crime/convicted_criminal	/base/fight/crime_type
/education/educational_institution/subsidiary_or_constituent_schools	/education/educational_institution	/education/educational_institution
/biology/domesticated_animal/breeds	/biology/domesticated_animal	/biology/animal_breed
/people/deceased_person/place_of_cremation	/people/deceased_person	/location/location
/film/film/sequel	/film/film	/film/film
/religion/religious_leader/religious_leadership./religion/religious_organization_leadership/organization	/religion/religious_leader	/religion/religious_organization
/organization/organization/headquarters./location/mailing_address/citytown	/organization/organization	/location/location
/film/personal_film_appearance_type/film_appearances./film/personal_film_appearance/person	/film/personal_film_appearance_type	/film/person_or_entity_appearing_in_film
/fictional_universe/fictional_job_title/fictional_characters_with_this_job./fictional_universe/fictional_employment_tenure/employee	/fictional_universe/fictional_job_title	/fictional_universe/fictional_character
/location/country/currency_formerly_used	/location/country	/finance/currency
/education/academic/advisors	/education/academic	/education/academic
/government/political_party/ideology	/government/political_party	/government/political_ideology
/organization/organization/founders	/organization/organization	/organization/organization_founder
/people/person/places_lived./people/place_lived/location	/people/person	/location/location
/sports/sports_equipment/sport_used_for	/sports/sports_equipment	/sports/sport
/user/robert/military/military_person/participated_in_conflicts	/user/robert/military/military_person	/military/military_conflict
/comic_books/comic_book_fictional_universe/characters_primarily_appearing_in_this_universe	/comic_books/comic_book_fictional_universe	/comic_books/comic_book_character
/music/instrument/family	/music/instrument	/music/instrument
/education/educational_institution/students_graduates./education/education/student	/education/educational_institution	/people/person
/base/x2010fifaworldcupsouthafrica/world_cup_participant/world_cup_team./base/x2010fifaworldcupsouthafrica/current_world_cup_squad/current_club	/base/x2010fifaworldcupsouthafrica/world_cup_participant	/soccer/football_team
/american_football/football_player/rushing./american_football/player_rushing_statistics/season	/american_football/football_player	/sports/sports_league_season
/comic_books/comic_book_character/primary_universe	/comic_books/comic_book_character	/comic_books/comic_book_fictional_universe
/base/biblioness/bibs_location/city	/base/biblioness/bibs_location	/location/location
/film/film_crewmember/films_crewed./film/film_crew_gig/film_crew_role	/film/film_crewmember	/film/film_job
/government/political_appointer/appointees./government/government_position_held/governmental_body	/government/political_appointer	/government/governmental_body
/cvg/cvg_developer/games_developed	/cvg/cvg_developer	/cvg/computer_videogame
/tv/tv_series_episode/guest_personal_appearances./tv/tv_guest_personal_appearance/person	/tv/tv_series_episode	/tv/tv_program_guest
/sports/sports_award_winner/awards./sports/sports_award/season	/sports/sports_award_winner	/sports/sports_league_season
/broadcast/content/producer	/broadcast/content	/broadcast/producer
/award/hall_of_fame_induction_category/inductees./award/hall_of_fame_induction/inductee	/award/hall_of_fame_induction_category	/award/hall_of_fame_inductee
/fictional_universe/fictional_character/rank	/fictional_universe/fictional_character	/fictional_universe/character_rank
/sports/sports_team/season_record./sports/sports_team_season_record/season	/sports/sports_team	/sports/sports_league_season
/language/human_language/dialects	/language/human_language	/language/language_dialect
/interests/collection_category/sub_categories	/interests/collection_category	/interests/collection_category
/tv/tv_actor/starring_roles./tv/regular_tv_appearance/special_performance_type	/tv/tv_actor	/tv/special_tv_performance_type
/government/political_appointer/appointees./government/government_position_held/office_position_or_title	/government/political_appointer	/government/government_office_or_title
/base/schemastaging/organization_extra/phone_number./base/schemastaging/phone_sandbox/product_or_service	/base/schemastaging/organization_extra	/base/schemastaging/contact_product
/visual_art/visual_art_form/artworks	/visual_art/visual_art_form	/visual_art/artwork
/common/annotation_category/annotations	/common/annotation_category	/common/webpage
/olympics/olympic_participating_country/medals_won./olympics/olympic_medal_honor/olympics	/olympics/olympic_participating_country	/olympics/olympic_games
/film/film/cinematography	/film/film	/film/cinematographer
/language/human_language/writing_system	/language/human_language	/language/language_writing_system
/base/fight/crime_type/victims_of_this_crime_type	/base/fight/crime_type	/base/crime/crime_victim
/people/appointee/position./people/appointment/appointed_by	/people/appointee	/people/appointer
/cvg/computer_videogame/characters./cvg/game_performance/character	/cvg/computer_videogame	/cvg/game_character
/fictional_universe/character_species/characters_of_this_species	/fictional_universe/character_species	/fictional_universe/fictional_character
/medicine/drug_ingredient/active_moiety_of_drug	/medicine/drug_ingredient	/medicine/drug
/medicine/symptom/side_effect_of	/medicine/symptom	/medicine/medical_treatment
/film/film/other_crew./film/film_crew_gig/film_crew_role	/film/film	/film/film_job
/government/governmental_jurisdiction/governing_officials./government/government_position_held/appointed_by	/government/governmental_jurisdiction	/government/political_appointer
/olympics/olympic_medal/medal_winners./olympics/olympic_medal_honor/olympics	/olympics/olympic_medal	/olympics/olympic_games
/base/petbreeds/dog_breed/size./base/petbreeds/dog_size/gender	/base/petbreeds/dog_breed	/base/petbreeds/pet_gender
/location/country/currency_used	/location/country	/finance/currency
/user/alexander/philosophy/subject/philosophers	/user/alexander/philosophy/subject	/user/alexander/philosophy/philosopher
/aviation/airline_alliance/member_airlines	/aviation/airline_alliance	/aviation/airline
/military/military_conflict/military_personnel_involved	/military/military_conflict	/military/military_person
/film/film/release_date_s./film/film_regional_release_date/film_release_region	/film/film	/location/location
/religion/religion/practices	/religion/religion	/religion/religious_practice
/media_common/dedicator/dedications./media_common/dedication/work_dedicated	/media_common/dedicator	/media_common/dedicated_work
/tv/tv_program_guest/appeared_on./tv/tv_guest_personal_appearance/appearance_type	/tv/tv_program_guest	/tv/non_character_role
/comic_books/comic_book_character/created_by	/comic_books/comic_book_character	/comic_books/comic_book_creator
/computer/software/languages_used	/computer/software	/computer/programming_language
/base/thoroughbredracing/thoroughbred_racehorse/sex	/base/thoroughbredracing/thoroughbred_racehorse	/base/thoroughbredracing/thoroughbred_racehorse_sex
/award/ranked_list/ranked_list_items./award/ranking/item	/award/ranked_list	/award/ranked_item
/sports/professional_sports_team/draft_picks./sports/sports_league_draft_pick/draft	/sports/professional_sports_team	/sports/sports_league_draft
/olympics/olympic_games/medals_awarded./olympics/olympic_medal_honor/medal	/olympics/olympic_games	/olympics/olympic_medal
/base/localfood/produce/availability./base/localfood/produce_availability/location	/base/localfood/produce	/base/localfood/food_producing_region
/award/competition/instance_of_recurring_competition	/award/competition	/award/recurring_competition
/sports/sports_position/players./sports/sports_team_roster/player	/sports/sports_position	/sports/pro_athlete
/geography/island/island_group	/geography/island	/geography/island_group
/film/film_character/portrayed_in_films_dubbed./film/dubbing_performance/actor	/film/film_character	/film/actor
/award/award_category/nominees./award/award_nomination/nominated_for	/award/award_category	/award/award_nominated_work
/cvg/cvg_genre/games	/cvg/cvg_genre	/cvg/computer_videogame
/military/military_person/service./military/military_service/rank	/military/military_person	/military/rank
/medicine/drug_ingredient/more_specific_ingredient	/medicine/drug_ingredient	/medicine/drug_ingredient
/baseball/baseball_league/teams	/baseball/baseball_league	/baseball/baseball_team
/organization/organization_type/organizations_of_this_type	/organization/organization_type	/organization/organization
/aviation/aircraft_manufacturer/aircraft_models_made	/aviation/aircraft_manufacturer	/aviation/aircraft_model
/film/film/starring./film/performance/character	/film/film	/film/film_character
/people/family/country	/people/family	/location/country
/visual_art/artwork/art_form	/visual_art/artwork	/visual_art/visual_art_form
/award/award_nominee/award_nominations./award/award_nomination/award_nominee	/award/award_nominee	/award/award_nominee
/location/administrative_division/country	/location/administrative_division	/location/country
/music/performance_role/guest_performances./music/recording_contribution/contributor	/music/performance_role	/music/artist
/government/government_office_or_title/office_holders./government/government_position_held/basic_title	/government/government_office_or_title	/government/government_office_category
/people/appointed_role/appointment./people/appointment/appointee	/people/appointed_role	/people/appointee
/geography/lake/basin_countries	/geography/lake	/location/country
/government/governmental_jurisdiction/governing_officials./government/government_position_held/basic_title	/government/governmental_jurisdiction	/government/government_office_category
/travel/tourist_attraction/near_travel_destination	/travel/tourist_attraction	/travel/travel_destination
/book/author/works_written	/book/author	/book/written_work
/broadcast/content/language	/broadcast/content	/language/human_language
/food/ingredient/compatible_with_dietary_restrictions	/food/ingredient	/food/dietary_restriction
/basketball/basketball_position/player_roster_position./sports/sports_team_roster/player	/basketball/basketball_position	/sports/pro_athlete
/american_football/football_team/historical_coaching_staff./american_football/football_historical_coach_position/position	/american_football/football_team	/american_football/football_coach_position
/base/nobelprizes/nobel_subject_area/nobel_awards./base/nobelprizes/nobel_honor/subject_area	/base/nobelprizes/nobel_subject_area	/base/nobelprizes/nobel_subject_area
/film/film/distributors./film/film_film_distributor_relationship/film_distribution_medium	/film/film	/film/film_distribution_medium
/people/person/gender	/people/person	/people/gender
/award/hall_of_fame/inductees./award/hall_of_fame_induction/inductee	/award/hall_of_fame	/award/hall_of_fame_inductee
/religion/religion/deities	/religion/religion	/religion/deity
/language/language_dialect/language	/language/language_dialect	/language/human_language
/award/award_nominee/award_nominations./award/award_nomination/award	/award/award_nominee	/award/award_category
/people/deceased_person/cause_of_death	/people/deceased_person	/people/cause_of_death
/tv/tv_program_creator/programs_created	/tv/tv_program_creator	/tv/tv_program
/education/educational_institution/students_graduates./education/education/minor	/education/educational_institution	/education/field_of_study
/location/location/people_born_here	/location/location	/people/person
/biology/breed_group/breeds_in_this_group./biology/breed_registration/breed	/biology/breed_group	/biology/animal_breed
/tv/non_character_role/tv_regular_personal_appearances./tv/tv_regular_personal_appearance/person	/tv/non_character_role	/tv/tv_personality
/film/film_job/films_with_this_crew_job./film/film_crew_gig/crewmember	/film/film_job	/film/film_crewmember
/internet/website/category	/internet/website	/internet/website_category
/book/newspaper/headquarters./location/mailing_address/state_province_region	/book/newspaper	/location/administrative_division
/location/location/nearby_airports	/location/location	/aviation/airport
/sports/sports_league_draft/picks./sports/sports_league_draft_pick/school	/sports/sports_league_draft	/education/educational_institution
/government/government_agency/jurisdiction	/government/government_agency	/government/governmental_jurisdiction
/tv/tv_program/regular_cast./tv/regular_tv_appearance/special_performance_type	/tv/tv_program	/tv/special_tv_performance_type
/base/popstra/celebrity/religion./base/popstra/religion_choice/religion	/base/popstra/celebrity	/base/popstra/religion
/government/government_office_category/officeholders./government/government_position_held/legislative_sessions	/government/government_office_category	/government/legislative_session
/food/ingredient/dishes	/food/ingredient	/food/dish
/geography/river/mouth	/geography/river	/location/location
/location/location/contains	/location/location	/location/location
/book/periodical_publisher/periodicals_published./book/periodical_publisher_period/periodical	/book/periodical_publisher	/book/periodical
/film/film_location/featured_in_films	/film/film_location	/film/film
/base/collectives/collective/members./base/collectives/collective_membership/member	/base/collectives/collective	/base/collectives/collective_member
/medicine/disease/parent_disease	/medicine/disease	/medicine/disease
/film/film/other_crew./film/film_crew_gig/crewmember	/film/film	/film/film_crewmember
/film/film_festival/individual_festivals	/film/film_festival	/film/film_festival_event
/medicine/disease/medical_specialties	/medicine/disease	/medicine/medical_specialty
/chemistry/chemical_compound/solubility./chemistry/solubility_relationship/solvent	/chemistry/chemical_compound	/chemistry/chemical_compound
/organization/organization/involved_in_merger./organization/organization_merger/organizations_merging	/organization/organization	/organization/organization
/business/board_member/organization_board_memberships./organization/organization_board_membership/organization	/business/board_member	/organization/organization
/tv/tv_program/tv_producer./tv/tv_producer_term/producer	/tv/tv_program	/tv/tv_producer
/base/petbreeds/dog_breed_group/dog_breeds	/base/petbreeds/dog_breed_group	/base/petbreeds/dog_breed
/organization/organization/geographic_scope	/organization/organization	/organization/organization_scope
/language/human_language/countries_spoken_in	/language/human_language	/location/country
/aviation/aircraft_model/number_owned_by./aviation/aircraft_ownership_count/aircraft_owner	/aviation/aircraft_model	/aviation/aircraft_owner
/user/robert/us_congress/us_representative/congressional_caucus_memberships	/user/robert/us_congress/us_representative	/user/robert/us_congress/congressional_caucus
/education/educational_institution/campuses	/education/educational_institution	/education/educational_institution_campus
/basketball/basketball_player/position_s	/basketball/basketball_player	/basketball/basketball_position
/business/board_member/leader_of./organization/leadership/role	/business/board_member	/organization/role
/sports/sport/leagues	/sports/sport	/sports/sports_league
/book/periodical/subjects	/book/periodical	/book/periodical_subject
/martial_arts/martial_art/well_known_practitioner	/martial_arts/martial_art	/martial_arts/martial_artist
/education/academic/advisees	/education/academic	/education/academic
/protected_sites/iucn_category/protected_areas	/protected_sites/iucn_category	/protected_sites/protected_site
/astronomy/orbital_relationship/orbits	/astronomy/orbital_relationship	/astronomy/orbital_relationship
/music/group_member/artists_supported	/music/group_member	/music/artist
/architecture/type_of_museum/museums	/architecture/type_of_museum	/architecture/museum
/sports/sports_team/sport	/sports/sports_team	/sports/sport
/fictional_universe/fictional_character/married_to./fictional_universe/marriage_of_fictional_characters/spouses	/fictional_universe/fictional_character	/fictional_universe/fictional_character
/education/educational_institution/sexes_accepted./education/gender_enrollment/sex	/education/educational_institution	/people/gender
/film/actor/dubbing_performances./film/dubbing_performance/character	/film/actor	/film/film_character
/tv/tv_actor/guest_roles./tv/tv_guest_role/special_performance_type	/tv/tv_actor	/tv/special_tv_performance_type
/venture_capital/venture_funded_company/venture_investors./venture_capital/venture_investment/investor	/venture_capital/venture_funded_company	/venture_capital/venture_investor
/symbols/name_source/namesakes	/symbols/name_source	/symbols/namesake
/award/award_winning_work/awards_won./award/award_honor/award_winner	/award/award_winning_work	/award/award_winner
/travel/transport_terminus/travel_destinations_served./travel/transportation/transport_terminus	/travel/transport_terminus	/travel/transport_terminus
/business/business_operation/operating_income./measurement_unit/dated_money_value/currency	/business/business_operation	/finance/currency
/base/crime/crime_victim/crime_type	/base/crime/crime_victim	/base/fight/crime_type
/media_common/dedicated_work/dedication./media_common/dedication/dedicated_by	/media_common/dedicated_work	/media_common/dedicator
/cvg/game_voice_actor/computer_game_voice_performances./cvg/game_performance/game	/cvg/game_voice_actor	/cvg/computer_videogame
/education/educational_degree/people_with_this_degree./education/education/institution	/education/educational_degree	/education/educational_institution
/military/military_combatant/casualties./military/casualties/military_conflict	/military/military_combatant	/military/military_conflict
/broadcast/broadcast/content	/broadcast/broadcast	/broadcast/content
/organization/organization/companies_acquired./business/acquisition/company_acquired	/organization/organization	/organization/organization
/comic_books/comic_book_series/publisher	/comic_books/comic_book_series	/comic_books/comic_book_publisher
/religion/religion/organizations	/religion/religion	/religion/religious_organization
/film/person_or_entity_appearing_in_film/films./film/personal_film_appearance/type_of_appearance	/film/person_or_entity_appearing_in_film	/film/personal_film_appearance_type
/base/americancomedy/impersonated_celebrity/impersonated_by	/base/americancomedy/impersonated_celebrity	/base/americancomedy/celebrity_impressionist
/base/aareas/schema/administrative_area/administrative_area_type	/base/aareas/schema/administrative_area	/base/aareas/schema/administrative_area_type
/tv/tv_program/seasons	/tv/tv_program	/tv/tv_series_season
/military/military_combatant/military_conflicts./military/military_combatant_group/conflict	/military/military_combatant	/military/military_conflict
/business/consumer_company/products./business/company_product_relationship/consumer_product	/business/consumer_company	/business/consumer_product
/business/asset_owner/assets_owned./business/asset_ownership/owned_asset	/business/asset_owner	/business/asset
/dining/restaurant/cuisine	/dining/restaurant	/dining/cuisine
/user/alexander/philosophy/philosopher/era	/user/alexander/philosophy/philosopher	/user/alexander/philosophy/era
/metropolitan_transit/transit_line/service_type	/metropolitan_transit/transit_line	/metropolitan_transit/transit_service_type
/fictional_universe/fictional_character/parents	/fictional_universe/fictional_character	/fictional_universe/fictional_character
/protected_sites/site_listing_category/listed_sites./protected_sites/natural_or_cultural_site_listing/listed_site	/protected_sites/site_listing_category	/protected_sites/listed_site
/film/actor/film./film/performance/film	/film/actor	/film/film
/food/food/nutrients./food/nutrition_fact/nutrient	/food/food	/food/nutrient
/geography/body_of_water/islands	/geography/body_of_water	/geography/island
/sports/sport/officials	/sports/sport	/sports/sports_official
/education/school_district/schools	/education/school_district	/education/school
/base/schemastaging/tv_character_extra/regular_dubbing_performances./base/schemastaging/tv_star_dubbing_performance/program	/base/schemastaging/tv_character_extra	/base/schemastaging/tv_program_extra
/religion/place_of_worship/religion	/religion/place_of_worship	/religion/religion
/aviation/airliner_accident/flight_destination	/aviation/airliner_accident	/location/location
/education/field_of_study/academics_in_this_field	/education/field_of_study	/education/academic
/fictional_universe/fictional_universe/works_set_here	/fictional_universe/fictional_universe	/fictional_universe/work_of_fiction
/base/popstra/celebrity/wears./base/popstra/fashion_choice/designer	/base/popstra/celebrity	/base/popstra/company
/ice_hockey/hockey_team/current_roster./sports/sports_team_roster/position	/ice_hockey/hockey_team	/sports/sports_position
/broadcast/radio_station_owner/radio_stations	/broadcast/radio_station_owner	/broadcast/radio_station
/tv/tv_writer/episodes_written	/tv/tv_writer	/tv/tv_series_episode
/film/film/personal_appearances./film/personal_film_appearance/person	/film/film	/film/person_or_entity_appearing_in_film
/base/nobelprizes/nobel_prize_winner/nobel_honor./base/nobelprizes/nobel_honor/subject_area	/base/nobelprizes/nobel_prize_winner	/base/nobelprizes/nobel_subject_area
/organization/organization/phone_number./common/phone_number/service_location	/organization/organization	/location/location
/time/event/locations	/time/event	/location/location
/tv/tv_program/original_network./tv/tv_network_duration/network	/tv/tv_program	/tv/tv_network
/broadcast/radio_format/stations	/broadcast/radio_format	/broadcast/radio_station
/film/editor/film	/film/editor	/film/film
/travel/travel_destination/local_transportation	/travel/travel_destination	/metropolitan_transit/transit_system
/base/fight/crime_type/people_convicted_of_this_crime./base/crime/criminal_conviction/guilty_of	/base/fight/crime_type	/base/fight/crime_type
/travel/travel_destination/how_to_get_here./travel/transportation/transport_terminus	/travel/travel_destination	/travel/transport_terminus
/dining/cuisine/restaurant	/dining/cuisine	/dining/restaurant
/sports/sport_country/athletic_performances./sports/competitor_competition_relationship/competitors	/sports/sport_country	/sports/tournament_event_competitor
/location/statistical_region/rent50_4./measurement_unit/dated_money_value/currency	/location/statistical_region	/finance/currency
/aviation/aircraft_model/aircraft_type	/aviation/aircraft_model	/aviation/aircraft_type
/film/film_distribution_medium/films_distributed_in_this_medium./film/film_film_distributor_relationship/film	/film/film_distribution_medium	/film/film
/aviation/airline/alliance	/aviation/airline	/aviation/airline_alliance
/organization/role/leaders./organization/leadership/organization	/organization/role	/organization/organization
/film/film/story_by	/film/film	/film/film_story_contributor
/visual_art/art_subject/artwork_on_the_subject	/visual_art/art_subject	/visual_art/artwork
/comic_books/comic_book_character/regular_featured_appearances	/comic_books/comic_book_character	/comic_books/comic_book_series
/award/award_ceremony/awards_presented./award/award_honor/award_winner	/award/award_ceremony	/award/award_winner
/games/game_genre/boardgames	/games/game_genre	/games/game
/law/judge/courts./law/judicial_tenure/court	/law/judge	/law/court
/media_common/dedicated_work/dedication./media_common/dedication/dedicated_to	/media_common/dedicated_work	/media_common/dedicatee
/award/ranked_item/appears_in_ranked_lists./award/ranking/list	/award/ranked_item	/award/ranked_list
/computer/programming_language/language_paradigms	/computer/programming_language	/computer/programming_language_paradigm
/military/military_person/participated_in_conflicts	/military/military_person	/military/military_conflict
/geography/lake/lake_type	/geography/lake	/geography/lake_type
/royalty/noble_title/noble_rank	/royalty/noble_title	/royalty/noble_rank
/government/legislative_session/members./government/government_position_held/district_represented	/government/legislative_session	/government/political_district
/military/military_combatant/force_deployments./military/force_strength/combatant	/military/military_combatant	/military/military_combatant
/film/film_subject/films	/film/film_subject	/film/film
/transportation/bridge/bridge_type	/transportation/bridge	/transportation/bridge_type
/cvg/gameplay_mode/games_with_this_mode	/cvg/gameplay_mode	/cvg/computer_videogame
/base/popstra/celebrity/friendship./base/popstra/friendship/participant	/base/popstra/celebrity	/base/popstra/celebrity
/symbols/namesake/named_after	/symbols/namesake	/symbols/name_source
/user/mt/default_domain/metabolite/biofluid_location	/user/mt/default_domain/metabolite	/medicine/biofluid
/base/schemastaging/organization_extra/phone_number./base/schemastaging/phone_sandbox/service_location	/base/schemastaging/organization_extra	/location/location
/cvg/computer_videogame/subjects	/cvg/computer_videogame	/cvg/computer_game_subject
/film/film/dubbing_performances./film/dubbing_performance/language	/film/film	/language/human_language
/music/album/artist	/music/album	/music/artist
/celebrities/celebrity/sexual_relationships./celebrities/romantic_relationship/celebrity	/celebrities/celebrity	/celebrities/celebrity
/cvg/computer_videogame/game_series	/cvg/computer_videogame	/cvg/game_series
/tv/tv_program/subjects	/tv/tv_program	/tv/tv_subject
/ice_hockey/hockey_position/players	/ice_hockey/hockey_position	/ice_hockey/hockey_player
/base/thoroughbredracing/thoroughbred_racehorse/country	/base/thoroughbredracing/thoroughbred_racehorse	/base/thoroughbredracing/thoroughbred_racehorse_origin
/olympics/olympic_games/athletes./olympics/olympic_athlete_affiliation/country	/olympics/olympic_games	/olympics/olympic_participating_country
/business/business_operation/retained_earnings./measurement_unit/dated_money_value/currency	/business/business_operation	/finance/currency
/architecture/structure/architectural_style	/architecture/structure	/architecture/architectural_style
/food/ingredient/cuisine	/food/ingredient	/dining/cuisine
/film/film/personal_appearances./film/personal_film_appearance/type_of_appearance	/film/film	/film/personal_film_appearance_type
/award/award_nominated_work/award_nominations./award/award_nomination/award_nominee	/award/award_nominated_work	/award/award_nominee
/tv/tv_location/tv_shows_filmed_here	/tv/tv_location	/tv/tv_program
/location/statistical_region/gni_per_capita_in_ppp_dollars./measurement_unit/dated_money_value/currency	/location/statistical_region	/finance/currency
/geography/island_group/islands_in_group	/geography/island_group	/geography/island
/user/hangy/default_domain/sports_team_gender/gender	/user/hangy/default_domain/sports_team_gender	/people/gender
/american_football/football_player/receiving./american_football/player_receiving_statistics/team	/american_football/football_player	/american_football/football_team
/education/fraternity_sorority/founded_location	/education/fraternity_sorority	/education/university
/cvg/computer_videogame/developer	/cvg/computer_videogame	/cvg/cvg_developer
/baseball/baseball_player/lifetime_batting_statistics./baseball/lifetime_batting_statistics/ending_season	/baseball/baseball_player	/sports/sports_league_season
/base/newsevents/news_reporting_organisation/news_reports./base/newsevents/news_report/event	/base/newsevents/news_reporting_organisation	/base/newsevents/news_reported_event
/sports/pro_athlete/teams./sports/sports_team_roster/position	/sports/pro_athlete	/sports/sports_position
/organization/organization/board_members./organization/organization_board_membership/member	/organization/organization	/business/board_member
/royalty/royal_line/monarchs_from_this_line	/royalty/royal_line	/royalty/monarch
/base/petbreeds/dog_breed/color	/base/petbreeds/dog_breed	/base/petbreeds/dog_coat_color
/film/film_character/portrayed_in_films_dubbed./film/dubbing_performance/language	/film/film_character	/language/human_language
/sports/professional_sports_team/owner_s	/sports/professional_sports_team	/sports/sports_team_owner
/fictional_universe/fictional_character/employers./fictional_universe/fictional_employment_tenure/title	/fictional_universe/fictional_character	/fictional_universe/fictional_job_title
/broadcast/producer/produces	/broadcast/producer	/broadcast/content
/business/business_operation/liabilities./measurement_unit/dated_money_value/currency	/business/business_operation	/finance/currency
/organization/non_profit_organization/registered_with./organization/non_profit_registration/registering_agency	/organization/non_profit_organization	/government/government_agency
/award/award_category/category_of	/award/award_category	/award/award
/architecture/museum/address./location/mailing_address/state_province_region	/architecture/museum	/location/administrative_division
/business/business_operation/current_assets./measurement_unit/dated_money_value/currency	/business/business_operation	/finance/currency
/royalty/chivalric_order_member/belongs_to_order./royalty/chivalric_order_membership/order	/royalty/chivalric_order_member	/royalty/order_of_chivalry
/film/film/executive_produced_by	/film/film	/film/producer
/base/fight/crime_type/people_convicted_of_this_crime./base/crime/criminal_conviction/convicted_person	/base/fight/crime_type	/base/crime/convicted_criminal
/royalty/monarch/kingdom	/royalty/monarch	/royalty/kingdom
/base/ecology/ecosystem/ecosystem_members	/base/ecology/ecosystem	/base/ecology/food_web_member
/government/governmental_body/members./government/government_position_held/office_position_or_title	/government/governmental_body	/government/government_office_or_title
/royalty/noble_title/used_in./royalty/system_title_relationship/system	/royalty/noble_title	/royalty/system_of_nobility
/location/country/official_language	/location/country	/language/human_language
/music/performance_role/regular_performances./music/group_membership/member	/music/performance_role	/music/group_member
/user/radiusrs/default_domain/astrology/related_topics	/user/radiusrs/default_domain/astrology	/common/topic
/people/place_of_interment/interred_here	/people/place_of_interment	/people/deceased_person
/sports/sports_championship_event/championship	/sports/sports_championship_event	/sports/sports_championship
/film/film/release_date_s./film/film_regional_release_date/film_release_distribution_medium	/film/film	/film/film_distribution_medium
/military/rank/used_by_services./military/military_service/military_person	/military/rank	/military/military_person
/base/schemastaging/fish/found_in	/base/schemastaging/fish	/base/schemastaging/body_of_water_extra
/user/robert/us_congress/congressional_district/state	/user/robert/us_congress/congressional_district	/location/us_state
/sports/school_sports_team/school	/sports/school_sports_team	/education/educational_institution
/location/country/administrative_divisions	/location/country	/location/administrative_division
/award/award_winner/awards_won./award/award_honor/honored_for	/award/award_winner	/award/award_winning_work
/people/appointee/position./people/appointment/appointed_role	/people/appointee	/people/appointed_role
/olympics/olympic_medal/medal_winners./olympics/olympic_medal_honor/medalist	/olympics/olympic_medal	/olympics/olympic_athlete
/people/ethnicity/includes_groups	/people/ethnicity	/people/ethnicity
/base/contractbridge/bridge_tournament/standing./base/contractbridge/bridge_tournament_standings/second_place	/base/contractbridge/bridge_tournament	/base/contractbridge/bridge_player
/sports/sports_team/roster./soccer/football_roster_position/player	/sports/sports_team	/soccer/football_player
/architecture/structure/address./location/mailing_address/citytown	/architecture/structure	/location/location
/sports/sports_team/roster./american_football/football_historical_roster_position/player	/sports/sports_team	/american_football/football_player
/sports/sports_team/roster./basketball/basketball_roster_position/player	/sports/sports_team	/basketball/basketball_player
/sports/pro_athlete/teams./american_football/football_historical_roster_position/team	/sports/pro_athlete	/american_football/football_team
/american_football/football_player/former_teams./american_football/football_historical_roster_position/position_s	/american_football/football_player	/american_football/position
/ice_hockey/hockey_player/current_team./sports/sports_team_roster/position	/ice_hockey/hockey_player	/sports/sports_position
/baseball/baseball_player/current_team./sports/sports_team_roster/position	/baseball/baseball_player	/sports/sports_position
/sports/sports_position/players./american_football/football_historical_roster_position/team	/sports/sports_position	/american_football/football_team
/ice_hockey/hockey_player/current_team./ice_hockey/hockey_roster_position/team	/ice_hockey/hockey_player	/ice_hockey/hockey_team
/basketball/basketball_team/roster./basketball/basketball_roster_position/player	/basketball/basketball_team	/basketball/basketball_player
/architecture/structure/address./location/mailing_address/state_province_region	/architecture/structure	/location/administrative_division
/sports/sports_position/players./soccer/football_roster_position/player	/sports/sports_position	/soccer/football_player
/soccer/football_player/current_team./sports/sports_team_roster/team	/soccer/football_player	/sports/sports_team
/sports/pro_athlete/teams./american_football/football_roster_position/team	/sports/pro_athlete	/american_football/football_team
/ice_hockey/hockey_team/current_roster./ice_hockey/hockey_roster_position/player	/ice_hockey/hockey_team	/ice_hockey/hockey_player
/ice_hockey/hockey_player/current_team./ice_hockey/hockey_roster_position/position	/ice_hockey/hockey_player	/ice_hockey/hockey_position
/sports/sports_position/players./baseball/baseball_roster_position/team	/sports/sports_position	/baseball/baseball_team
/baseball/baseball_player/former_teams./baseball/baseball_historical_roster_position/team	/baseball/baseball_player	/baseball/baseball_team
/sports/sports_team/roster./soccer/football_roster_position/position	/sports/sports_team	/soccer/football_position
/soccer/football_player/current_team./soccer/football_roster_position/team	/soccer/football_player	/soccer/football_team
/american_football/football_team/current_roster./american_football/football_roster_position/position	/american_football/football_team	/american_football/position
/sports/sports_position/players./soccer/football_roster_position/team	/sports/sports_position	/soccer/football_team
/ice_hockey/hockey_player/former_team_s./ice_hockey/hockey_previous_roster_position/team	/ice_hockey/hockey_player	/ice_hockey/hockey_team
/american_football/football_team/historical_roster./american_football/football_historical_roster_position/player	/american_football/football_team	/american_football/football_player
/basketball/basketball_player/team./basketball/basketball_roster_position/position	/basketball/basketball_player	/basketball/basketball_position
/sports/sports_position/players./american_football/football_roster_position/team	/sports/sports_position	/american_football/football_team
/sports/sports_team/roster./baseball/baseball_roster_position/player	/sports/sports_team	/baseball/baseball_player
/soccer/football_team/current_roster./soccer/football_roster_position/position	/soccer/football_team	/soccer/football_position
/american_football/football_player/former_teams./sports/sports_team_roster/position	/american_football/football_player	/sports/sports_position
/sports/pro_athlete/teams./soccer/football_roster_position/position	/sports/pro_athlete	/soccer/football_position
/american_football/football_player/current_team./sports/sports_team_roster/team	/american_football/football_player	/sports/sports_team
/sports/sports_team/roster./american_football/football_roster_position/player	/sports/sports_team	/american_football/football_player
/american_football/football_team/historical_roster./american_football/football_historical_roster_position/position_s	/american_football/football_team	/american_football/position
/basketball/basketball_team/historical_roster./basketball/basketball_historical_roster_position/player	/basketball/basketball_team	/basketball/basketball_player
/baseball/baseball_team/current_roster./baseball/baseball_roster_position/position	/baseball/baseball_team	/baseball/baseball_position
/sports/sports_team/roster./basketball/basketball_historical_roster_position/player	/sports/sports_team	/basketball/basketball_player
/sports/sports_position/players./ice_hockey/hockey_roster_position/player	/sports/sports_position	/ice_hockey/hockey_player
/american_football/football_position/players	/american_football/position	/american_football/football_player
/american_football/football_player/current_team./american_football/football_roster_position/team	/american_football/football_player	/american_football/football_team
/baseball/baseball_player/former_teams./sports/sports_team_roster/team	/baseball/baseball_player	/sports/sports_team
/sports/sports_team/roster./american_football/football_historical_roster_position/position_s	/sports/sports_team	/american_football/position
/sports/pro_athlete/teams./basketball/basketball_roster_position/team	/sports/pro_athlete	/basketball/basketball_team
/basketball/basketball_player/former_teams./sports/sports_team_roster/team	/basketball/basketball_player	/sports/sports_team
/baseball/baseball_team/historical_roster./baseball/baseball_historical_roster_position/player	/baseball/baseball_team	/baseball/baseball_player
/sports/pro_athlete/teams./baseball/baseball_roster_position/team	/sports/pro_athlete	/baseball/baseball_team
/sports/pro_athlete/teams./ice_hockey/hockey_roster_position/position	/sports/pro_athlete	/ice_hockey/hockey_position
/sports/sports_position/players./american_football/football_historical_roster_position/player	/sports/sports_position	/american_football/football_player
/ice_hockey/hockey_team/historical_roster./ice_hockey/hockey_previous_roster_position/player	/ice_hockey/hockey_team	/ice_hockey/hockey_player
/basketball/basketball_player/team./basketball/basketball_roster_position/team	/basketball/basketball_player	/basketball/basketball_team
/sports/pro_athlete/teams./baseball/baseball_roster_position/position	/sports/pro_athlete	/baseball/baseball_position
/sports/sports_position/players./basketball/basketball_roster_position/team	/sports/sports_position	/basketball/basketball_team
/soccer/football_player/current_team./soccer/football_roster_position/position	/soccer/football_player	/soccer/football_position
/sports/sports_team/roster./basketball/basketball_roster_position/position	/sports/sports_team	/basketball/basketball_position
/sports/sports_team/roster./ice_hockey/hockey_roster_position/position	/sports/sports_team	/ice_hockey/hockey_position
/basketball/basketball_player/former_teams./basketball/basketball_historical_roster_position/team	/basketball/basketball_player	/basketball/basketball_team
/american_football/football_player/former_teams./american_football/football_historical_roster_position/team	/american_football/football_player	/american_football/football_team
/sports/sports_position/players./american_football/football_historical_roster_position/position_s	/sports/sports_position	/american_football/position
/sports/pro_athlete/teams./ice_hockey/hockey_previous_roster_position/team	/sports/pro_athlete	/ice_hockey/hockey_team
/soccer/football_team/current_roster./soccer/football_roster_position/player	/soccer/football_team	/soccer/football_player
/ice_hockey/hockey_player/current_team./sports/sports_team_roster/team	/ice_hockey/hockey_player	/sports/sports_team
/sports/sports_position/players./baseball/baseball_roster_position/player	/sports/sports_position	/baseball/baseball_player
/soccer/football_player/current_team./sports/sports_team_roster/position	/soccer/football_player	/sports/sports_position
/sports/sports_position/players./ice_hockey/hockey_roster_position/team	/sports/sports_position	/ice_hockey/hockey_team
/sports/pro_athlete/teams./american_football/football_historical_roster_position/position_s	/sports/pro_athlete	/american_football/position
/baseball/baseball_player/current_team./baseball/baseball_roster_position/position	/baseball/baseball_player	/baseball/baseball_position
/basketball/basketball_team/roster./basketball/basketball_roster_position/position	/basketball/basketball_team	/basketball/basketball_position
/baseball/baseball_player/current_team./sports/sports_team_roster/team	/baseball/baseball_player	/sports/sports_team
/sports/sports_team/roster./american_football/football_roster_position/position	/sports/sports_team	/american_football/position
/american_football/football_player/former_teams./sports/sports_team_roster/team	/american_football/football_player	/sports/sports_team
/sports/pro_athlete/teams./baseball/baseball_historical_roster_position/team	/sports/pro_athlete	/baseball/baseball_team
/sports/pro_athlete/teams./ice_hockey/hockey_roster_position/team	/sports/pro_athlete	/ice_hockey/hockey_team
/sports/pro_athlete/teams./basketball/basketball_historical_roster_position/team	/sports/pro_athlete	/basketball/basketball_team
/american_football/football_team/current_roster./american_football/football_roster_position/player	/american_football/football_team	/american_football/football_player
/american_football/football_player/current_team./american_football/football_roster_position/position	/american_football/football_player	/american_football/position
/basketball/basketball_position/player_roster_position./basketball/basketball_roster_position/team	/basketball/basketball_position	/basketball/basketball_team
/basketball/basketball_player/team./sports/sports_team_roster/position	/basketball/basketball_player	/sports/sports_position
/basketball/basketball_player/team./sports/sports_team_roster/team	/basketball/basketball_player	/sports/sports_team
/sports/pro_athlete/teams./basketball/basketball_roster_position/position	/sports/pro_athlete	/basketball/basketball_position
/ice_hockey/hockey_team/current_roster./ice_hockey/hockey_roster_position/position	/ice_hockey/hockey_team	/ice_hockey/hockey_position
/sports/sports_team/roster./baseball/baseball_historical_roster_position/player	/sports/sports_team	/baseball/baseball_player
/baseball/baseball_player/current_team./baseball/baseball_roster_position/team	/baseball/baseball_player	/baseball/baseball_team
/sports/sports_team/roster./ice_hockey/hockey_roster_position/player	/sports/sports_team	/ice_hockey/hockey_player
/baseball/baseball_team/current_roster./baseball/baseball_roster_position/player	/baseball/baseball_team	/baseball/baseball_player
/sports/pro_athlete/teams./soccer/football_roster_position/team	/sports/pro_athlete	/soccer/football_team
/ice_hockey/hockey_player/former_team_s./sports/sports_team_roster/team	/ice_hockey/hockey_player	/sports/sports_team
/sports/sports_team/roster./ice_hockey/hockey_previous_roster_position/player	/sports/sports_team	/ice_hockey/hockey_player
/basketball/basketball_position/player_roster_position./basketball/basketball_roster_position/player	/basketball/basketball_position	/basketball/basketball_player
/sports/sports_position/players./basketball/basketball_roster_position/player	/sports/sports_position	/basketball/basketball_player
/sports/sports_team/roster./baseball/baseball_roster_position/position	/sports/sports_team	/baseball/baseball_position
/sports/pro_athlete/teams./american_football/football_roster_position/position	/sports/pro_athlete	/american_football/position
